zipcode,Households!!Total,Households!!Median income (dollars),Households!!Mean income (dollars),Families!!Total,Total!!Population for whom poverty status is determined,Total!!Population for whom poverty status is determined!!SEX!!Male,Total!!Population for whom poverty status is determined!!SEX!!Female,Below poverty level!!Population for whom poverty status is determined,Percent below poverty level!!Population for whom poverty status is determined,"Total number of housing units
",Total number of Occupied housing units,Total number of vacant housing units,Total population,RACE!!Total population!!One race!!White,RACE!!Total population!!One race!!Black or African American,RACE!!Total population!!One race!!American Indian and Alaska Native,RACE!!Total population!!One race!!Asian,RACE!!Total population!!One race!!Some Other Race
10001,15097,123393,205444,4715,27621,13772,13849,4293,15.5,17554,15097,2457,29079,15893,3070,32,5228,1653
10002,35771,46525,93314,16924,74729,37794,36935,18611,24.9,39646,35771,3875,75517,23597,7074,262,27700,9006
10003,25080,153750,248577,6847,44368,22634,21734,5614,12.7,30730,25080,5650,53825,36193,2367,68,9639,1366
10004,1775,220592,309645,799,3860,2117,1743,157,4.1,2146,1775,371,3875,2460,278,0,923,33
10005,5156,211810,279387,1432,9238,4637,4601,424,4.6,6495,5156,1339,9238,6254,405,0,1311,433
10006,2305,209972,235292,792,4475,1974,2501,580,13,2605,2305,300,4475,2932,271,0,1058,127
10007,3309,"250,000+",512350,1690,7470,3366,4104,232,3.1,3711,3309,402,7802,5593,704,0,1179,76
10009,30025,87963,134024,10493,58283,29195,29088,11359,19.5,32375,30025,2350,58341,32293,5002,185,7533,6802
10010,16192,156127,253684,6113,29548,13989,15559,2696,9.1,19014,16192,2822,31905,20884,2912,112,4517,749
10011,28277,146571,238674,8360,47366,24006,23360,4295,9.1,35049,28277,6772,49344,35340,1950,60,5118,2516
10012,11909,130938,219222,3593,20871,9988,10883,2299,11,14568,11909,2659,21846,15076,715,66,3780,718
10013,12609,159474,385678,6489,26287,12439,13848,2609,9.9,15933,12609,3324,28215,15873,1053,14,8621,680
10014,17682,167254,276638,5181,29384,14533,14851,1896,6.5,21835,17682,4153,29772,24317,907,58,1516,480
10016,30164,153065,217368,8528,52988,26146,26842,5180,9.8,36985,30164,6821,54297,33663,2534,65,10830,1011
10017,9529,132518,182585,2667,14945,6874,8071,1522,10.2,12866,9529,3337,14985,10102,491,28,2736,586
10018,4901,133042,219569,1467,8710,4349,4361,1434,16.5,5678,4901,777,8764,3871,874,189,2402,587
10019,26900,121835,198898,7667,43950,24087,19863,4682,10.7,33279,26900,6379,44276,26883,2740,239,8151,1976
10020,0,-,-,0,0,0,0,0,-,0,0,0,0,0,0,0,0,0
10021,20319,156712,279563,9515,38853,17038,21815,1941,5,29248,20319,8929,39479,32620,232,0,3888,1084
10022,18627,171038,283490,7884,34048,15812,18236,2265,6.7,25686,18627,7059,34340,26374,672,27,4026,914
10023,36881,157866,255254,14476,65388,30409,34979,5658,8.7,46272,36881,9391,67468,45595,3139,99,10948,2700
10024,29447,182614,311852,14502,61694,29057,32637,4788,7.8,36723,29447,7276,62576,50685,1883,51,2973,3383
10025,41029,109195,187891,19284,88473,41676,46797,13351,15.1,47649,41029,6620,93223,53927,9864,111,9406,9068
10026,15537,74140,126720,7321,37050,17557,19493,6551,17.7,17648,15537,2111,37113,9819,17758,29,2369,3032
10027,24509,64220,116529,10994,57272,28917,28355,13545,23.7,28038,24509,3529,65068,19634,23503,375,6669,9253
10028,24901,168125,282107,10580,45665,20429,25236,2299,5,29535,24901,4634,45679,38602,744,9,3177,670
10029,33098,38308,79430,16049,72382,31636,40746,22134,30.6,36955,33098,3857,74848,15835,23634,411,8940,16835
10030,13180,42738,80313,5756,30687,14460,16227,10015,32.6,14602,13180,1422,30781,4659,17951,107,1521,4021
10031,21991,65067,95724,10922,59744,29600,30144,13718,23,24110,21991,2119,60305,12743,17393,351,2621,14798
10032,21359,56588,83374,10009,54238,25986,28252,10884,20.1,23178,21359,1819,55579,12018,9029,268,2789,23681
10033,19747,75585,125737,10899,52745,26296,26449,8953,17,21338,19747,1591,53611,17974,3801,1162,1817,18382
10034,15462,69786,96915,8172,38979,18532,20447,5687,14.6,16599,15462,1137,39037,10488,4360,885,1265,14022
10035,15056,40556,74154,6856,38118,19267,18851,14181,37.2,16340,15056,1284,39082,7992,14923,664,2260,8232
10036,18886,100225,153956,4922,30218,17171,13047,4155,13.8,22473,18886,3587,30589,17012,2474,29,4670,1818
10037,10205,51250,88255,3675,18071,7686,10385,5049,27.9,11218,10205,1013,18333,2574,11736,77,775,1068
10038,10694,115121,168823,4247,21895,9960,11935,3939,18,12624,10694,1930,23342,10416,2604,43,6875,1233
10039,12427,48792,72337,6947,30425,14329,16096,8592,28.2,13300,12427,873,30512,3183,16742,143,446,4390
10040,16260,64022,91539,8748,40695,19431,21264,6741,16.6,17020,16260,760,41581,11008,2780,514,731,20024
10044,5146,106146,172339,2735,11313,5082,6231,1293,11.4,6004,5146,858,11998,5063,1772,0,3538,709
10065,16706,160938,267101,6611,30904,13660,17244,1860,6,22734,16706,6028,31047,23642,680,0,4055,683
10069,3202,226151,343678,1623,6669,3727,2942,1771,26.6,3647,3202,445,6669,3036,203,0,1947,1058
10075,12536,146556,292128,5424,23351,9789,13562,2959,12.7,16415,12536,3879,23865,19737,196,0,2276,250
10103,0,-,-,0,0,0,0,0,-,0,0,0,0,0,0,0,0,0
10110,0,-,-,0,0,0,0,0,-,0,0,0,0,0,0,0,0,0
10111,0,-,-,0,0,0,0,0,-,0,0,0,0,0,0,0,0,0
10112,0,-,-,0,0,0,0,0,-,0,0,0,0,0,0,0,0,0
10115,0,-,-,0,0,0,0,0,-,0,0,0,0,0,0,0,0,0
10119,0,-,-,0,0,0,0,0,-,0,0,0,0,0,0,0,0,0
10128,30154,148705,243787,13687,58712,26057,32655,5011,8.5,35940,30154,5786,59000,41579,3173,106,6166,2686
10152,0,-,-,0,0,0,0,0,-,99,0,99,0,0,0,0,0,0
10153,0,-,-,0,0,0,0,0,-,0,0,0,0,0,0,0,0,0
10154,0,-,-,0,0,0,0,0,-,0,0,0,0,0,0,0,0,0
10162,883,110349,138519,426,1769,884,885,79,4.5,1034,883,151,1769,1577,19,0,51,15
10165,0,-,-,0,0,0,0,0,-,0,0,0,0,0,0,0,0,0
10167,0,-,-,0,0,0,0,0,-,0,0,0,0,0,0,0,0,0
10168,0,-,-,0,0,0,0,0,-,0,0,0,0,0,0,0,0,0
10169,0,-,-,0,0,0,0,0,-,0,0,0,0,0,0,0,0,0
10170,0,-,-,0,0,0,0,0,-,0,0,0,0,0,0,0,0,0
10171,0,-,-,0,0,0,0,0,-,0,0,0,0,0,0,0,0,0
10172,0,-,-,0,0,0,0,0,-,0,0,0,0,0,0,0,0,0
10173,0,-,-,0,0,0,0,0,-,0,0,0,0,0,0,0,0,0
10174,0,-,-,0,0,0,0,0,-,0,0,0,0,0,0,0,0,0
10177,0,-,-,0,0,0,0,0,-,0,0,0,0,0,0,0,0,0
10199,0,-,-,0,0,0,0,0,-,0,0,0,0,0,0,0,0,0
10271,0,-,-,0,0,0,0,0,-,0,0,0,0,0,0,0,0,0
10278,0,-,-,0,0,0,0,0,-,0,0,0,0,0,0,0,0,0
10279,62,"250,000+",1210208,62,181,65,116,0,0,130,62,68,181,100,0,0,0,0
10280,4222,206250,343601,1985,8668,4186,4482,303,3.5,5015,4222,793,8668,5333,161,200,2463,77
10282,2584,"250,000+",468406,1516,5960,3257,2703,381,6.4,2950,2584,366,5960,4207,145,0,903,34
10301,14430,84937,116032,9008,38591,18744,19847,6808,17.6,16631,14430,2201,39799,17504,9748,318,3050,2931
10302,6159,76089,96783,4342,19666,10418,9248,3939,20,6927,6159,768,19693,6572,4435,319,1180,4122
10303,8742,79429,100468,6313,25956,12127,13829,4829,18.6,9580,8742,838,25993,6824,9294,84,2607,2764
10304,15900,71506,107989,10801,44617,21472,23145,7940,17.8,17524,15900,1624,45843,19743,12008,530,6090,3713
10305,15637,86294,113878,10590,41240,20250,20990,3568,8.7,16850,15637,1213,41714,26964,1251,248,8626,1629
10306,19846,97746,125636,14806,56818,28115,28703,5065,8.9,21299,19846,1453,57249,39494,1883,85,8985,1959
10307,5135,138807,160824,3940,14794,7758,7036,396,2.7,5390,5135,255,14821,12665,7,0,693,219
10308,10323,122654,138577,8276,29972,14338,15634,1738,5.8,11093,10323,770,29996,24886,229,59,2256,1008
10309,12108,123638,154589,9310,34750,17126,17624,2074,6,12770,12108,662,34918,30698,148,33,1390,1438
10310,8982,106118,122637,6503,25746,12409,13337,3422,13.3,9909,8982,927,25824,12927,5627,220,1338,2025
10311,0,-,-,0,0,0,0,0,-,0,0,0,0,0,0,0,0,0
10312,21366,111434,135032,16645,63324,30947,32377,4057,6.4,22547,21366,1181,63345,50048,800,33,5989,1189
10314,31419,104655,131486,23446,92443,45284,47159,9341,10.1,33554,31419,2135,93539,61357,3526,659,17404,3279
10451,21414,37111,59107,11352,48883,21967,26916,15676,32.1,21850,21414,436,48975,6413,23345,273,557,12202
10452,28397,37854,54449,17663,75256,35963,39293,26773,35.6,28854,28397,457,76745,8949,26617,763,705,28945
10453,28462,35482,53758,17793,77595,35000,42595,26120,33.7,28801,28462,339,78270,8812,25647,1306,998,28171
10454,14910,27500,55836,9278,40174,18536,21638,17197,42.8,15397,14910,487,40368,4879,12168,1044,243,15993
10455,16366,36701,53392,10287,42777,20048,22729,14098,33,16608,16366,242,42940,3655,13034,542,654,17733
10456,32601,35676,48755,19715,85724,39598,46126,31548,36.8,33321,32601,720,86958,8911,41291,1211,723,22861
10457,26715,44911,58366,17936,78637,36317,42320,26848,34.1,27795,26715,1080,79375,7143,33115,904,573,22418
10458,28856,42107,57371,16966,75230,35751,39479,22418,29.8,30592,28856,1736,78741,8937,14395,1371,3022,42951
10459,17919,39276,58743,11433,49182,23191,25991,16463,33.5,18678,17919,759,49753,3912,17104,491,558,19620
10460,22734,36067,56863,14246,60645,29142,31503,20584,33.9,24085,22734,1351,61101,6553,22229,685,610,19080
10461,19078,65023,90619,12225,49648,23618,26030,8320,16.8,20418,19078,1340,50900,20438,5128,480,6956,12850
10462,29538,63460,80576,18182,74730,36567,38163,14539,19.5,31828,29538,2290,75452,11771,18307,868,13732,23970
10463,29575,72952,101956,16495,67233,30450,36783,13246,19.7,30602,29575,1027,69373,26634,10503,1119,2788,16549
10464,2081,100306,132151,1220,4273,2083,2190,253,5.9,2255,2081,174,4273,2849,61,0,91,947
10465,16221,90255,110108,11065,44514,21831,22683,6168,13.9,17200,16221,979,46457,20938,6164,298,2676,9192
10466,25262,66328,90341,17976,72986,32861,40125,14540,19.9,26303,25262,1041,74061,4418,47389,745,1477,14899
10467,38210,47806,66931,22338,94609,44821,49788,25338,26.8,40582,38210,2372,96304,15203,29859,1338,6267,32776
10468,28608,46624,61402,18334,78488,38342,40146,20942,26.7,29553,28608,945,79825,8601,19158,1220,1852,36602
10469,23582,76018,98334,16775,67513,31513,36000,10226,15.1,25082,23582,1500,69855,8760,39845,453,4407,11096
10470,6625,81134,105951,3707,15444,7450,7994,1720,11.1,6869,6625,244,15558,6499,5290,187,410,1831
10471,9205,108738,147500,5152,20576,9817,10759,1265,6.1,9453,9205,248,23400,13377,2076,192,1069,3031
10472,21950,43125,60361,15103,63340,31426,31914,19923,31.5,24259,21950,2309,63820,4455,17362,776,5164,30286
10473,22734,50609,71363,14418,59055,27002,32053,14207,24.1,23234,22734,500,59778,7831,24534,412,1454,18555
10474,3917,41279,58859,2551,10636,5116,5520,3346,31.5,4092,3917,175,11188,741,3439,118,46,4716
10475,18692,62383,73880,11374,41795,19061,22734,6450,15.4,19333,18692,641,42771,3460,27364,306,796,6882
10501,469,231607,260900,372,1426,618,808,120,8.4,486,469,17,1426,1405,0,0,0,0
10502,1879,"250,000+",294577,1601,5837,2949,2888,205,3.5,2002,1879,123,5875,3896,98,0,763,346
10503,63,"250,000+",260817,63,127,61,66,0,0,143,63,80,127,127,0,0,0,0
10504,2540,247433,396809,2229,7772,4106,3666,327,4.2,2665,2540,125,7853,6016,150,0,595,446
10505,495,145250,217796,331,1295,609,686,23,1.8,495,495,0,1295,988,8,0,119,77
10506,2225,"250,000+",360722,1549,6242,3104,3138,180,2.9,2408,2225,183,6246,5396,119,0,153,202
10507,1805,106213,240364,1225,5144,2520,2624,434,8.4,2024,1805,219,6044,3368,459,4,867,489
10509,7326,120987,149796,5398,19830,10164,9666,1486,7.5,7839,7326,513,20055,13941,577,13,678,3208
10510,3734,215568,311303,2993,9827,5081,4746,510,5.2,3942,3734,208,10027,7859,134,0,763,248
10511,817,127375,155406,600,2296,1121,1175,86,3.7,849,817,32,2296,1413,173,5,134,188
10512,9170,124519,140094,6369,24099,11754,12345,1525,6.3,9874,9170,704,24238,18437,1087,81,438,2005
10514,4076,"250,000+",371010,3595,12227,6134,6093,411,3.4,4205,4076,129,12227,8784,487,0,1549,308
10516,2289,135922,179973,1589,5586,2790,2796,376,6.7,2603,2289,314,5607,5022,265,0,56,26
10517,165,110417,128342,123,551,228,323,24,4.4,165,165,0,551,349,18,0,35,98
10518,374,167368,345724,256,789,401,388,43,5.4,533,374,159,789,738,0,0,32,0
10519,107,-,N,47,188,128,60,0,0,107,107,0,188,60,0,0,128,0
10520,4989,140018,197365,3103,11930,5899,6031,566,4.7,5425,4989,436,12208,9935,529,3,385,699
10522,3853,167927,209355,2841,10705,5531,5174,661,6.2,4074,3853,221,11464,8182,400,10,1201,741
10523,3320,115809,149859,2441,9672,4471,5201,686,7.1,3727,3320,407,9773,3445,2147,92,1048,1883
10524,1613,125568,164852,1101,4285,2094,2191,371,8.7,1850,1613,237,4298,3720,59,0,44,153
10526,722,"250,000+",321361,600,2038,893,1145,30,1.5,795,722,73,2040,1625,8,0,196,26
10527,191,219698,287891,191,587,308,279,0,0,191,191,0,587,461,51,0,0,75
10528,4959,151193,226664,3669,13778,6437,7341,859,6.2,5101,4959,142,13822,10260,440,0,1392,998
10530,6493,118114,158500,3921,13942,6610,7332,796,5.7,6795,6493,302,13955,9687,1005,2,1439,573
10532,1822,134662,179653,1330,5141,2613,2528,275,5.3,1887,1822,65,5253,4535,63,0,204,252
10533,2587,171250,293766,2085,7320,3674,3646,113,1.5,2999,2587,412,7337,5706,75,0,627,274
10535,196,-,91328,54,323,142,181,84,26,196,196,0,323,146,47,0,0,130
10536,3434,239063,306462,2957,10606,5151,5455,795,7.5,3749,3434,315,11010,9159,205,32,388,214
10537,811,126354,137714,656,2418,1263,1155,143,5.9,984,811,173,2418,1980,2,0,57,0
10538,6715,186555,359787,5011,17656,8636,9020,467,2.6,7017,6715,302,17709,14078,733,16,656,414
10540,0,-,-,0,11,11,0,11,100,0,0,0,114,22,70,0,0,11
10541,8950,133929,154108,7190,25971,13147,12824,775,3,9614,8950,664,26137,20626,450,20,682,2349
10542,0,-,-,0,0,0,0,0,-,0,0,0,0,0,0,0,0,0
10543,7566,128418,196077,5434,20753,10554,10199,1526,7.4,8141,7566,575,21022,13445,1125,287,1075,2839
10545,0,-,-,0,182,182,0,107,58.8,0,0,0,182,120,12,0,9,41
10546,456,213250,245138,414,1229,490,739,25,2,502,456,46,1229,913,2,0,206,0
10547,2787,155295,168143,1892,7253,3358,3895,417,5.7,2956,2787,169,7361,4583,1211,8,193,640
10548,1228,140000,144895,899,3949,1846,2103,332,8.4,1401,1228,173,4302,3212,201,0,14,286
10549,5807,122327,191285,4046,15825,8271,7554,1167,7.4,6339,5807,532,15858,10715,895,0,440,2632
10550,15837,56903,79462,9059,39607,17898,21709,7320,18.5,16865,15837,1028,40072,2997,27600,392,475,3779
10552,9442,97105,135547,5702,21190,9080,12110,1437,6.8,10143,9442,701,21499,7216,8659,79,1031,2963
10553,3693,84173,115039,2585,10815,4930,5885,1005,9.3,3801,3693,108,10815,1403,7566,0,77,940
10560,1642,180455,218439,1265,4701,2497,2204,125,2.7,1851,1642,209,4914,4188,38,0,119,212
10562,12230,113069,152057,8645,31932,15178,16754,2514,7.9,12745,12230,515,33700,18336,2876,127,1382,7438
10566,10806,91042,115364,6369,25333,12534,12799,2528,10,11752,10806,946,25484,10050,4778,602,511,5979
10567,6587,152334,187475,5138,19822,9793,10029,900,4.5,7086,6587,499,20260,13603,1876,0,726,1158
10570,4285,188262,268128,3272,12271,6067,6204,442,3.6,4481,4285,196,13391,10818,549,0,445,732
10573,13951,110612,176596,10000,40728,21530,19198,4307,10.6,14592,13951,641,40982,19539,2509,390,1875,10278
10576,1814,227344,355093,1565,4904,2432,2472,213,4.3,1974,1814,160,4904,4521,75,0,117,62
10577,729,"250,000+",450273,681,2699,1172,1527,50,1.9,875,729,146,5901,4033,644,24,387,248
10578,568,"250,000+",237243,560,1851,1209,642,0,0,568,568,0,1851,551,90,0,306,904
10579,3011,135893,163628,2391,8825,4678,4147,159,1.8,3642,3011,631,8825,7109,209,51,236,701
10580,6178,242015,432282,4865,17897,9131,8766,504,2.8,6614,6178,436,18073,14345,316,28,1271,384
10583,14050,"250,000+",403974,11276,40508,20115,20393,1329,3.3,14914,14050,864,40612,26503,1131,25,8272,1678
10588,1108,171598,178405,833,3079,1364,1715,29,0.9,1172,1108,64,3081,2665,59,0,225,70
10589,3536,123293,158355,1844,7189,2994,4195,254,3.5,4020,3536,484,7266,6660,19,29,285,15
10590,2628,198563,250326,2141,7312,3772,3540,354,4.8,2820,2628,192,7314,6279,94,0,290,59
10591,10094,103480,163144,5981,23409,11621,11788,1566,6.7,10566,10094,472,23663,13441,986,90,1615,3357
10594,1792,166417,201719,1462,5488,2755,2733,220,4,1820,1792,28,5512,4666,39,0,212,366
10595,2360,108750,174450,1536,6048,2952,3096,869,14.4,2543,2360,183,7180,5006,657,29,612,411
10596,389,81893,137325,164,657,318,339,51,7.8,450,389,61,657,442,53,0,1,23
10597,194,211591,259207,179,652,356,296,0,0,234,194,40,652,449,0,0,0,190
10598,10299,163040,195257,8104,28890,14277,14613,970,3.4,10994,10299,695,28894,22571,1559,16,1055,1668
10601,5313,90733,133168,2378,10658,4796,5862,1997,18.7,6031,5313,718,10860,4983,1617,139,1272,2110
10603,7277,121450,154592,5097,19083,9509,9574,1464,7.7,7624,7277,347,19201,7518,4334,33,976,3882
10604,4273,111131,185731,3024,12068,5576,6492,492,4.1,4436,4273,163,12192,7980,891,250,399,1183
10605,7933,145587,205076,5036,19251,9413,9838,1206,6.3,8537,7933,604,19371,13032,1679,0,1607,1329
10606,6420,114956,166099,4041,17239,8456,8783,2441,14.2,6920,6420,500,17556,6119,2545,0,1633,4870
10607,2224,161250,207024,1609,6011,2734,3277,397,6.6,2291,2224,67,6222,2044,1981,11,738,1025
10701,27163,63310,91977,17031,69513,33954,35559,12640,18.2,28252,27163,1089,70054,18909,15858,1047,2192,19637
10703,7553,74940,107752,5289,21865,9680,12185,3167,14.5,7925,7553,372,22135,8206,4815,40,1023,4605
10704,12032,110097,118247,7954,31795,14966,16829,3429,10.8,12576,12032,544,31844,17671,2898,13,1784,4711
10705,14995,68616,102773,9623,40171,19936,20235,7217,18,15620,14995,625,40390,10660,6791,440,1991,13860
10706,3357,177031,271732,2389,8874,4372,4502,258,2.9,3413,3357,56,9119,7590,146,0,463,240
10707,3957,141837,181106,2415,9612,4529,5083,544,5.7,4186,3957,229,9755,6476,363,0,1211,981
10708,9425,121107,222143,5607,20449,9906,10543,1508,7.4,10004,9425,579,21946,16178,1534,16,817,1199
10709,3690,175424,225616,2698,10274,5076,5198,287,2.8,3897,3690,207,10274,8517,71,0,886,112
10710,9979,100783,127307,6336,25607,12403,13204,2707,10.6,10107,9979,128,25684,11269,3966,418,2942,3903
10801,16030,83534,127834,9306,39944,20121,19823,5837,14.6,16912,16030,882,41984,15461,10361,300,2767,6246
10803,4239,212288,323987,3368,13096,6431,6665,347,2.6,4360,4239,121,13096,9301,863,0,873,432
10804,5267,220089,294869,4314,15189,7739,7450,474,3.1,5327,5267,60,15228,11813,1811,0,516,304
10805,8530,89964,132371,5390,20228,9731,10497,1991,9.8,8731,8530,201,21230,9487,3603,194,956,4313
10901,9273,114651,144046,6165,25876,11631,14245,2395,9.3,9674,9273,401,26224,18728,2899,190,1241,1693
10910,0,-,-,0,0,0,0,0,-,0,0,0,0,0,0,0,0,0
10911,8,-,N,8,18,0,18,0,0,8,8,0,18,8,10,0,0,0
10913,1518,175000,190378,1264,4790,2323,2467,454,9.5,1572,1518,54,5333,4010,142,0,351,77
10914,156,-,89686,144,691,406,285,0,0,156,156,0,691,216,283,0,0,0
10915,0,-,-,0,0,0,0,0,-,0,0,0,0,0,0,0,0,0
10916,1468,115227,135542,1244,4436,2352,2084,168,3.8,1545,1468,77,4531,3321,377,0,147,192
10917,480,126522,181475,415,1575,970,605,46,2.9,611,480,131,1575,1135,68,0,112,234
10918,4185,147011,162759,2929,11645,5449,6196,1003,8.6,4607,4185,422,11937,8429,483,24,387,1252
10919,539,106185,106501,460,1383,852,531,25,1.8,539,539,0,1383,711,24,0,46,73
10920,2869,143672,187414,2305,8493,3948,4545,454,5.3,2940,2869,71,8493,5680,26,0,862,504
10921,1564,107500,137824,1171,4352,2270,2082,260,6,1630,1564,66,4358,2981,242,223,210,306
10922,543,88516,121074,205,1072,646,426,40,3.7,557,543,14,1072,796,122,43,31,15
10923,2866,95769,131181,2038,9072,4533,4539,1144,12.6,2909,2866,43,9188,3845,973,0,494,2102
10924,4671,114567,150029,3276,12723,6302,6421,717,5.6,5178,4671,507,13612,10287,579,269,386,794
10925,1755,89313,117142,1231,4424,2198,2226,388,8.8,2220,1755,465,4440,3604,44,115,166,71
10926,1409,98135,124913,909,3725,1567,2158,324,8.7,1495,1409,86,3741,1964,412,37,314,747
10927,3910,67447,94352,2824,12111,6330,5781,2056,17,4180,3910,270,12273,3230,2205,185,330,3369
10928,2277,96106,108019,1160,5273,2928,2345,456,8.6,2442,2277,165,5273,2555,854,13,264,466
10930,3423,141893,153116,2688,10331,5155,5176,538,5.2,3647,3423,224,10342,6516,1356,32,660,172
10931,383,81406,100442,256,1170,522,648,86,7.4,403,383,20,1170,425,179,53,8,367
10932,7,-,N,7,14,7,7,0,0,7,7,0,14,0,0,0,0,14
10933,99,-,75389,74,312,93,219,122,39.1,131,99,32,312,312,0,0,0,0
10940,18680,87198,107356,12672,52403,26587,25816,6654,12.7,19930,18680,1250,53099,23066,12055,1386,2066,7393
10941,5428,95938,116019,3615,14756,7501,7255,1367,9.3,5486,5428,58,14761,7013,3173,187,677,1361
10950,16009,77123,105043,13607,64892,31922,32970,17780,27.4,17531,16009,1522,65391,55396,2106,325,797,3163
10952,11031,70696,108362,9540,46920,23398,23522,16679,35.5,11743,11031,712,47169,41494,3022,5,431,568
10953,0,-,-,0,0,0,0,0,-,26,0,26,0,0,0,0,0,0
10954,9590,112927,160547,6698,26942,12399,14543,2123,7.9,10041,9590,451,27474,14755,4250,79,3689,1525
10956,9592,179060,201331,8153,31101,15646,15455,1360,4.4,9892,9592,300,31420,19466,2060,183,4033,2655
10958,816,156250,170141,641,2348,1240,1108,47,2,904,816,88,2717,1988,269,2,25,55
10960,6212,126404,180940,3512,14537,6974,7563,811,5.6,6680,6212,468,15277,9428,2814,0,713,647
10962,1646,171389,179053,1300,4763,2160,2603,173,3.6,1678,1646,32,4921,3149,237,0,761,242
10963,1178,79265,105997,737,2821,1555,1266,231,8.2,1281,1178,103,3940,2271,779,14,149,329
10964,514,-,245846,324,1395,608,787,67,4.8,567,514,53,1395,1056,81,6,220,20
10965,5605,136970,161838,3991,15512,8158,7354,956,6.2,5937,5605,332,15526,12043,195,199,583,2262
10968,1122,132105,167961,589,2406,1319,1087,10,0.4,1345,1122,223,2406,2042,27,0,236,35
10969,425,154127,175352,316,1333,720,613,38,2.9,478,425,53,1333,1101,115,0,7,94
10970,3959,118445,140632,3029,11623,5455,6168,957,8.2,4138,3959,179,11636,5699,2114,68,847,1556
10973,755,133508,143690,611,2300,1159,1141,244,10.6,817,755,62,2300,1577,187,68,34,86
10974,1228,112404,152648,741,3275,1716,1559,143,4.4,1286,1228,58,3324,2322,261,153,198,128
10975,125,102608,75670,77,254,156,98,31,12.2,152,125,27,254,56,170,0,0,0
10976,603,95956,119973,361,1692,696,996,198,11.7,681,603,78,2215,1420,227,0,190,84
10977,16360,77724,110251,13662,70629,36383,34246,20535,29.1,17339,16360,979,71465,40807,12034,287,1893,12764
10979,43,-,N,43,84,41,43,0,0,43,43,0,84,84,0,0,0,0
10980,4816,125333,139575,3686,13793,7112,6681,393,2.8,5081,4816,265,13793,9411,1819,0,368,778
10983,1899,178664,204353,1592,5461,2645,2816,26,0.5,1926,1899,27,5489,3985,172,0,670,382
10984,916,109583,152194,745,2760,1456,1304,66,2.4,916,916,0,2760,1870,207,0,115,318
10985,6,-,N,6,18,12,6,0,0,6,6,0,18,18,0,0,0,0
10986,592,-,141410,334,1402,625,777,102,7.3,621,592,29,1402,1102,89,0,47,87
10987,1446,164063,299054,971,4014,2042,1972,674,16.8,1646,1446,200,4041,2956,327,0,137,199
10988,222,104615,151364,175,684,282,402,61,8.9,235,222,13,684,572,33,0,0,9
10989,3179,131501,168990,2275,8213,3926,4287,255,3.1,3379,3179,200,8410,5856,508,0,1001,154
10990,7774,123199,153890,5675,20220,9851,10369,952,4.7,8394,7774,620,20370,17347,563,296,316,806
10992,3303,113450,132395,2429,10407,5123,5284,697,6.7,3559,3303,256,10412,6067,1077,4,127,1885
10993,1462,65250,105877,890,4216,2106,2110,418,9.9,1462,1462,0,4230,1417,603,37,122,1319
10994,2131,166838,193610,1623,5925,2950,2975,108,1.8,2178,2131,47,5925,4252,270,0,692,373
10996,1118,139700,156326,1038,4105,2044,2061,137,3.3,1241,1118,123,6549,4866,411,0,266,209
10998,1203,117212,146736,1020,3673,1886,1787,293,8,1273,1203,70,3676,2856,150,7,0,241
11001,8508,144755,181986,6735,25694,12891,12803,948,3.7,8923,8508,415,25714,14226,1544,151,6312,1453
11003,12068,123000,146612,10207,44541,22036,22505,2291,5.1,12641,12068,573,44716,7588,18739,322,7557,5674
11004,5093,109865,124377,3188,13694,6717,6977,1596,11.7,5394,5093,301,14296,4097,817,0,7435,1030
11005,1535,91719,312858,574,2195,802,1393,191,8.7,2011,1535,476,2195,2102,0,29,64,0
11010,8380,140686,159234,6827,25480,12515,12965,1233,4.8,8577,8380,197,25618,16975,1220,26,3129,2111
11020,1770,169265,238780,1614,5986,3033,2953,375,6.3,1893,1770,123,5986,2436,861,0,2581,15
11021,8116,122390,191917,5057,19183,8669,10514,1117,5.8,8705,8116,589,19474,11358,281,142,5947,839
11023,3117,151544,216258,2323,9813,4975,4838,610,6.2,3398,3117,281,9824,7335,129,0,1629,384
11024,2166,170476,223531,1908,8036,4028,4008,518,6.4,2454,2166,288,8821,7324,140,0,471,742
11030,6035,247393,382070,5057,17541,8670,8871,651,3.7,6531,6035,496,17703,12407,236,0,3553,313
11040,13884,153511,189189,11590,42165,20688,21477,1482,3.5,14608,13884,724,42344,18307,529,338,18556,1709
11042,0,-,-,0,0,0,0,0,-,0,0,0,232,177,41,0,7,0
11050,11656,153819,238606,8785,32262,15857,16405,1312,4.1,12329,11656,673,32657,22498,580,27,3199,3101
11096,2553,88160,120728,2032,9746,5116,4630,1327,13.6,2706,2553,153,9897,3699,1503,26,822,3096
11101,19049,116807,159301,7947,38609,19564,19045,5306,13.7,27093,19049,8044,39007,14613,4173,261,12179,3389
11102,13176,102996,130950,5797,28019,13977,14042,3456,12.3,19431,13176,6255,28349,14744,1833,218,4449,3736
11103,16211,92787,136638,7771,35305,17629,17676,3626,10.3,18833,16211,2622,35357,21137,1014,124,4520,3992
11104,12234,84716,106656,6252,26744,12972,13772,2348,8.8,13224,12234,990,26825,11994,779,54,7601,2228
11105,16068,100306,129329,8622,38433,19174,19259,3521,9.2,17518,16068,1450,38507,25080,1604,312,4133,3005
11106,18970,85573,114092,8508,40529,19959,20570,5971,14.7,21681,18970,2711,40657,19097,3242,420,7534,5310
11109,3638,198773,242553,2036,7388,4020,3368,200,2.7,4826,3638,1188,7388,4554,48,0,2059,142
11201,33141,169285,243020,14432,65955,30660,35295,6847,10.4,36155,33141,3014,69251,41843,8597,113,9950,1897
11203,30149,68028,88652,19440,75125,34120,41005,12054,16,33434,30149,3285,76853,4312,61075,123,1352,2556
11204,25306,67588,88033,19880,80979,39435,41544,16358,20.2,27498,25306,2192,81368,44863,975,587,23781,7747
11205,17272,86753,142490,8861,48002,22578,25424,12820,26.7,19200,17272,1928,50205,27195,10866,374,3381,3198
11206,33696,57280,88480,17672,88998,41882,47116,29486,33.1,34838,33696,1142,89231,37667,18331,763,5891,16825
11207,35309,55419,74315,20587,92390,41266,51124,25189,27.3,38030,35309,2721,93445,10443,55477,267,1476,16782
11208,34486,59988,80641,25011,106115,51575,54540,21330,20.1,37261,34486,2775,106901,11350,47996,115,11220,27551
11209,30376,92656,125801,17111,70347,33825,36522,7952,11.3,33286,30376,2910,70756,45955,2099,896,9614,5569
11210,21440,83261,116476,14520,60026,29814,30212,6731,11.2,22817,21440,1377,60398,18556,30791,148,3301,2910
11211,27497,105183,155194,12214,65492,33083,32409,13883,21.2,29068,27497,1571,65691,41352,3926,285,4580,9476
11212,32588,40060,58158,19972,86942,36710,50232,29308,33.7,34782,32588,2194,87946,5860,61636,218,993,8218
11213,27060,62040,91348,14869,68663,31840,36823,15321,22.3,29186,27060,2126,69630,17385,40773,34,1179,4945
11214,31006,64286,95206,21536,88181,43287,44894,16652,18.9,33341,31006,2335,88994,37446,1961,864,33593,9598
11215,29747,180773,246090,17560,70394,35196,35198,4207,6,32197,29747,2450,70922,50513,2582,298,6460,3225
11216,26664,95000,130791,10944,59588,26472,33116,9487,15.9,28825,26664,2161,59913,18885,28305,79,3057,2701
11217,19543,158314,235997,8381,42046,19395,22651,4266,10.1,21590,19543,2047,42569,22392,7472,105,4028,2200
11218,26053,95916,150487,16751,70509,35736,34773,8765,12.4,27403,26053,1350,71313,37197,6725,618,13344,5283
11219,24476,55685,84493,19366,93825,48645,45180,29832,31.8,27973,24476,3497,94737,58245,1331,664,20090,11611
11220,28336,64201,88838,20358,90294,44729,45565,21056,23.3,30897,28336,2561,90792,20328,2277,1458,36377,23913
11221,36032,85122,112905,17954,90357,42131,48226,19831,21.9,38690,36032,2658,90750,20702,36876,795,5215,13797
11222,20277,123963,159569,8098,41204,20046,21158,3933,9.5,21917,20277,1640,41418,29416,1720,162,2422,2486
11223,26433,63950,96022,18816,78172,37561,40611,15207,19.5,28857,26433,2424,78566,41478,4446,293,20502,8509
11224,19991,41449,68938,12114,47327,21681,25646,13369,28.2,21354,19991,1363,48469,24103,11552,187,4123,5244
11225,24747,85201,111100,12582,56521,26760,29761,8054,14.2,26703,24747,1956,56544,16108,30571,28,1723,3153
11226,39305,81084,108093,22600,99482,46427,53055,15218,15.3,42618,39305,3313,100022,15760,60532,1108,4063,9111
11228,15105,80737,116610,11163,42083,20819,21264,5562,13.2,16336,15105,1231,42325,21557,576,204,15485,2690
11229,30924,72556,106957,20553,79545,38637,40908,12545,15.8,33353,30924,2429,79802,48542,5301,86,17803,3176
11230,31802,69522,98968,20249,87760,43430,44330,16727,19.1,34269,31802,2467,88252,53196,7645,646,14698,7109
11231,16810,138485,219505,9610,39677,18610,21067,5139,13,18265,16810,1455,39704,25607,4937,74,1956,2724
11232,9336,87517,120897,5186,24790,13065,11725,4230,17.1,10004,9336,668,26681,9232,1951,1049,4002,7203
11233,32784,62034,86547,18435,82077,38022,44055,19365,23.6,34412,32784,1628,82711,11722,56487,327,1280,6509
11234,32178,94434,126358,23509,87539,40484,47055,8530,9.7,35167,32178,2989,87778,31896,37589,432,7205,4895
11235,35333,61689,96127,21869,80872,38471,42401,14103,17.4,37188,35333,1855,81958,56257,2345,189,12036,3865
11236,33318,82813,105299,24242,94212,43054,51158,12541,13.3,37002,33318,3684,95174,4638,76552,86,2286,4005
11237,17723,82570,99019,8064,45077,23061,22016,9391,20.8,18801,17723,1078,45233,14395,5924,1100,3084,13170
11238,27371,132957,180373,11492,57947,26125,31822,6798,11.7,29588,27371,2217,58462,29245,14695,252,4106,2571
11239,8320,35675,59115,4037,15886,6235,9651,3941,24.8,8883,8320,563,16047,2590,9773,429,478,1354
11249,17621,121400,195247,9510,45174,21468,23706,8726,19.3,18958,17621,1337,45353,30646,4453,222,2402,3056
11354,21275,62833,89334,13575,50724,24412,26312,9173,18.1,22979,21275,1704,52325,8894,1652,152,33855,4536
11355,30651,53700,76760,20746,79438,38144,41294,17299,21.8,32049,30651,1398,79802,6736,2016,234,59546,7624
11356,8372,91445,105289,6677,26933,13513,13420,2518,9.3,9003,8372,631,26956,6063,167,20,9503,9106
11357,15755,97754,133319,10884,41983,19464,22519,3816,9.1,16586,15755,831,42341,24702,225,562,10683,2845
11358,13209,88729,115361,9742,36426,17978,18448,3793,10.4,13806,13209,597,36496,11513,286,182,17961,3997
11359,0,-,-,0,0,0,0,0,-,0,0,0,0,0,0,0,0,0
11360,8822,100250,130675,5099,19416,9191,10225,1489,7.7,9874,8822,1052,19510,11055,310,148,5810,1022
11361,11229,108391,132705,7724,29775,13732,16043,2761,9.3,11934,11229,705,30402,12630,1125,100,12696,1702
11362,7093,118989,138099,4942,18034,8688,9346,1032,5.7,7634,7093,541,18156,7235,687,0,8798,520
11363,2890,110833,170131,2099,7515,3558,3957,670,8.9,3002,2890,112,7515,4266,40,82,2175,83
11364,13753,101222,123194,9969,36388,17530,18858,2540,7,14527,13753,774,36417,11649,946,360,18456,2289
11365,16024,85375,107865,11267,43258,20808,22450,4096,9.5,16626,16024,602,43258,10702,4947,151,18762,3823
11366,4518,117402,138075,3291,12831,6580,6251,1362,10.6,4915,4518,397,12967,4183,642,0,5695,1577
11367,14716,75804,100262,10265,40950,18718,22232,5726,14,15693,14716,977,42210,19206,3772,412,10679,5168
11368,29859,71798,88448,22321,105262,54787,50475,19308,18.3,31165,29859,1306,107060,16774,10626,1570,13101,49569
11369,10131,80577,97663,7460,32463,16908,15555,4904,15.1,13893,10131,3762,33354,4233,6079,281,4720,13199
11370,8764,74895,101592,5797,25060,12449,12611,2696,10.8,11679,8764,2915,28762,9858,2161,386,7229,5226
11371,0,-,-,0,0,0,0,0,-,0,0,0,0,0,0,0,0,0
11372,25384,77133,108259,16256,66565,34629,31936,9920,14.9,26613,25384,1229,66995,20478,1268,526,13919,16788
11373,32373,71470,90797,22951,98329,49278,49051,11575,11.8,34797,32373,2424,99433,9152,1765,693,47837,32081
11374,19503,86333,111155,11907,45946,22111,23835,6557,14.3,21197,19503,1694,46128,19584,1990,76,13685,4844
11375,33217,104319,144481,19263,74847,35804,39043,5928,7.9,35415,33217,2198,75320,38374,2367,188,21118,5150
11377,33371,73292,105205,19122,83058,41230,41828,8961,10.8,34928,33371,1557,83545,24765,1973,631,30248,9032
11378,13013,84762,108263,9255,37485,18711,18774,4938,13.2,14522,13013,1509,37828,21357,311,376,5611,5869
11379,13897,92509,116226,9644,36931,17996,18935,2694,7.3,15237,13897,1340,37378,24758,597,54,4279,4418
11385,37586,87365,111194,23851,103625,51073,52552,11880,11.5,40175,37586,2589,103865,55544,3906,747,7205,18305
11411,6518,118393,130626,5080,20354,8992,11362,1221,6,6775,6518,257,20501,663,17469,0,451,814
11412,12095,98418,119566,9368,41164,18368,22796,3967,9.6,12821,12095,726,41350,639,32817,211,1748,3470
11413,13712,114766,130053,11013,44776,19705,25071,2657,5.9,14485,13712,773,45072,737,38579,109,703,3220
11414,11523,98209,135426,7834,31090,15267,15823,1911,6.1,12223,11523,700,31090,20701,1917,71,1485,3002
11415,8967,88632,127361,4877,21237,10763,10474,1992,9.4,9794,8967,827,21379,10329,1522,211,4357,2646
11416,7501,85544,117863,6173,26428,13473,12955,3973,15,8047,7501,546,26660,4601,1361,153,8715,7238
11417,9371,86330,112125,7171,29928,14337,15591,3676,12.3,9855,9371,484,30091,7645,2233,546,8849,5891
11418,11608,84927,111301,8308,35718,17881,17837,3528,9.9,12072,11608,464,36304,8341,2968,513,8714,10003
11419,13020,91231,113667,10667,46608,23841,22767,5393,11.6,13607,13020,587,46938,2618,5553,1181,16158,14016
11420,13975,98584,121895,11851,49932,25862,24070,5410,10.8,14835,13975,860,50060,3505,10464,1069,17081,9332
11421,11986,89439,114848,9595,41859,21106,20753,4152,9.9,12776,11986,790,41937,9471,2355,247,8567,10986
11422,10341,108519,128930,7604,32854,15366,17488,2784,8.5,10694,10341,353,33085,2352,26337,0,655,1267
11423,9824,80870,105423,7306,28571,13824,14747,3006,10.5,10307,9824,483,29105,3140,9973,175,8961,4517
11424,0,-,-,0,0,0,0,0,-,0,0,0,0,0,0,0,0,0
11426,6379,107591,128402,4893,19581,9965,9616,1400,7.1,6813,6379,434,19638,4838,1107,0,9857,1989
11427,8121,92129,114861,6125,24761,11961,12800,2846,11.5,8435,8121,314,25124,4210,5720,22,9404,3044
11428,6022,84977,112597,4815,18740,9516,9224,1690,9,6335,6022,313,18898,1887,3309,60,6164,4825
11429,8227,98232,119032,6557,27647,12953,14694,2384,8.6,8601,8227,374,27933,1230,18587,244,1869,3017
11430,0,-,-,0,361,171,190,296,82,0,0,0,448,221,159,0,9,22
11432,20404,75395,105490,14990,62173,31002,31171,9439,15.2,21618,20404,1214,63730,8839,11640,542,26934,10274
11433,10965,71177,94394,8550,37534,17626,19908,4636,12.4,11849,10965,884,37777,1003,20769,561,6562,7069
11434,22737,76668,102298,15830,66535,29776,36759,7833,11.8,23787,22737,1050,67611,2318,53168,189,2393,5012
11435,19928,79430,100579,13154,57942,29337,28605,8268,14.3,21180,19928,1252,58424,8266,14678,428,13343,17510
11436,6289,86104,109526,5031,21143,10094,11049,2612,12.4,6617,6289,328,21364,394,12922,100,1406,4244
11439,0,-,-,0,0,0,0,0,-,0,0,0,2171,1077,470,0,164,11
11451,0,-,-,0,0,0,0,0,-,0,0,0,0,0,0,0,0,0
11501,8788,138323,160402,5657,21364,11259,10105,1389,6.5,9174,8788,386,21590,14250,360,0,3052,1864
11507,2296,162991,202025,1850,6581,3155,3426,220,3.3,2432,2296,136,6581,3078,48,0,2917,264
11509,744,162500,233892,550,1747,787,960,29,1.7,1193,744,449,1747,1641,9,0,12,29
11510,11111,141120,169678,8776,34699,17091,17608,1801,5.2,11463,11111,352,34814,11467,14652,119,1229,2817
11514,1677,136125,169878,1240,4421,2104,2317,122,2.8,1758,1677,81,4421,3048,104,0,592,418
11516,3141,102083,142793,2139,8733,4229,4504,418,4.8,3346,3141,205,8733,7134,106,0,103,537
11518,4077,104955,159106,2750,10293,4329,5964,259,2.5,4235,4077,158,10390,8339,449,71,372,576
11520,14129,119407,141983,9994,44484,22295,22189,2737,6.2,14912,14129,783,44873,10667,15345,96,685,10555
11530,9539,202841,268772,7243,27036,13246,13790,921,3.4,10178,9539,639,28041,23874,381,18,1557,588
11542,10879,92284,125033,7241,28423,13630,14793,3690,13,11374,10879,495,29020,18429,1429,287,1373,3409
11545,4358,164583,305389,3448,11943,5774,6169,328,2.7,4686,4358,328,11963,9774,92,34,927,597
11547,328,123452,148717,215,788,397,391,0,0,328,328,0,788,715,0,0,48,0
11548,421,107386,200929,344,1250,706,544,138,11,421,421,0,2171,1576,150,0,370,3
11549,0,-,-,0,2,2,0,2,100,0,0,0,2420,1714,256,0,221,31
11550,18025,86904,114797,13274,59345,28825,30520,8500,14.3,19579,18025,1554,60658,7103,26762,225,1453,16388
11552,7477,153192,170966,6342,25979,12650,13329,1671,6.4,7736,7477,259,26053,13426,5232,78,1319,3848
11553,7215,105994,130486,5872,26762,13288,13474,2970,11.1,7365,7215,150,28344,5057,12243,77,359,6227
11554,11727,128770,156724,9008,34759,15584,19175,2382,6.9,12128,11727,401,35806,23060,1453,7,6678,2577
11556,0,-,-,0,0,0,0,0,-,0,0,0,0,0,0,0,0,0
11557,2624,170048,222576,2357,8503,4241,4262,268,3.2,2792,2624,168,8503,6442,549,9,785,262
11558,3133,109443,138477,2132,8393,4215,4178,755,9,3317,3133,184,8532,6608,132,0,410,705
11559,2630,156429,257910,2039,9130,4579,4551,463,5.1,2849,2630,219,9130,7196,584,0,159,977
11560,2418,159545,314732,2022,6885,3532,3353,334,4.9,2534,2418,116,6951,5993,133,16,229,80
11561,16554,132903,158455,8977,37677,19206,18471,2762,7.3,18442,16554,1888,38847,30710,1641,44,1901,1891
11563,7644,138006,173108,5805,22422,10571,11851,1507,6.7,8088,7644,444,22558,15218,1767,25,1589,1606
11565,3239,145290,185615,2622,8908,4425,4483,486,5.5,3466,3239,227,8908,6478,384,0,294,521
11566,11563,169868,202242,9812,34975,17594,17381,987,2.8,11723,11563,160,35172,29444,901,10,1250,570
11568,1011,"250,000+",446538,817,3120,1534,1586,162,5.2,1090,1011,79,4198,2999,269,0,589,69
11569,509,108371,169801,253,996,494,502,75,7.5,805,509,296,996,959,0,0,0,0
11570,10724,147784,204126,7399,27873,13748,14125,1401,5,11368,10724,644,28162,21661,1594,143,1428,1314
11572,10460,144419,178259,8130,30358,15978,14380,842,2.8,10811,10460,351,30627,24929,533,54,894,955
11575,4442,133534,147196,4030,19099,9007,10092,770,4,4597,4442,155,19430,2360,10310,167,463,4738
11576,4441,232279,320695,3714,12796,6213,6583,561,4.4,4552,4441,111,12796,9214,210,0,2454,670
11577,4287,183233,253684,3415,12471,6067,6404,494,4,4453,4287,166,12771,8270,207,3,2820,318
11579,1759,185650,276255,1300,5003,2233,2770,78,1.6,1977,1759,218,5037,4510,29,0,68,71
11580,12912,135385,161194,10189,42494,20460,22034,1485,3.5,13582,12912,670,42644,10516,12247,23,7356,6589
11581,7108,138821,163105,5765,22602,10684,11918,1388,6.1,7423,7108,315,22652,9500,4112,25,3818,2836
11590,15146,149250,184835,11224,47682,24003,23679,2352,4.9,15497,15146,351,48243,18922,8224,56,5698,7843
11596,3375,162026,201085,2802,10378,5242,5136,335,3.2,3450,3375,75,10378,7284,46,6,2073,653
11598,3806,181574,246283,3238,14084,6750,7334,428,3,4079,3806,273,14316,11882,548,10,188,728
11691,22382,57027,87977,14408,66476,31601,34875,13847,20.8,23400,22382,1018,68704,19256,29159,411,2844,8709
11692,7981,49507,89324,5210,22497,10612,11885,6112,27.2,8475,7981,494,23247,3769,12952,65,1301,1779
11693,5405,67829,94035,3487,12955,5432,7523,2347,18.1,5850,5405,445,13066,6668,3364,19,603,988
11694,8046,103792,131803,4929,20802,9895,10907,2433,11.7,9103,8046,1057,21430,16544,1750,26,389,1113
11697,1668,134844,160574,1055,4123,1933,2190,206,5,2837,1668,1169,4123,4050,0,0,27,0
11701,9033,110639,143569,6212,27580,13110,14470,2356,8.5,9544,9033,511,28174,11280,8066,130,1001,4387
11702,5470,136711,171310,3601,13950,6742,7208,518,3.7,5939,5470,469,14002,12446,170,103,159,408
11703,5516,130140,138457,4153,17124,8910,8214,671,3.9,5665,5516,149,17205,10474,2463,110,986,1793
11704,12924,127034,149694,9208,39601,19345,20256,2287,5.8,13406,12924,482,40285,27582,4861,63,652,4136
11705,2948,161214,182774,2407,8256,4185,4071,383,4.6,2988,2948,40,8256,7451,166,1,59,213
11706,19324,115112,135932,14227,68023,34248,33775,4984,7.3,21435,19324,2111,68648,29294,7749,265,4249,17910
11709,2580,143571,183003,1891,6730,3143,3587,253,3.8,2803,2580,223,6744,6033,5,0,139,111
11710,11301,173136,207467,9308,34313,17386,16927,1134,3.3,11717,11301,416,34459,28130,767,69,1763,764
11713,3136,111786,142411,2230,9221,4659,4562,771,8.4,3788,3136,652,9236,5526,1387,37,205,1143
11714,7828,123679,152243,5987,22475,10857,11618,1475,6.6,7925,7828,97,22475,16267,93,139,3251,947
11715,1650,157905,154609,1037,3796,1817,1979,280,7.4,1742,1650,92,3796,3579,7,0,24,66
11716,3359,120344,139984,2441,9696,5159,4537,773,8,3535,3359,176,9750,8301,175,0,418,121
11718,1033,203750,229273,870,3180,1520,1660,7,0.2,1033,1033,0,3185,2844,84,0,12,50
11719,1120,96638,124513,676,2959,1462,1497,513,17.3,1174,1120,54,3300,2822,181,8,12,102
11720,8734,128015,151576,7132,28598,14237,14361,1466,5.1,9407,8734,673,28669,21413,1807,30,2001,1491
11721,2436,206250,277524,1905,6620,3331,3289,367,5.5,2497,2436,61,6620,5755,116,0,180,342
11722,9877,110365,124759,7115,37644,19002,18642,3494,9.3,10824,9877,947,38443,11069,7370,204,734,10990
11724,977,"250,000+",284364,753,2886,1534,1352,71,2.5,1059,977,82,2956,2571,3,0,129,86
11725,9189,168324,205259,7741,28562,14328,14234,999,3.5,9452,9189,263,29050,24830,595,0,1670,410
11726,6102,125691,142824,4762,20940,10625,10315,1627,7.8,6492,6102,390,21940,7018,3629,172,485,5763
11727,11266,101515,126830,7165,29112,14208,14904,2549,8.8,11851,11266,585,29393,16037,4645,19,1783,1728
11729,8661,138350,161880,6177,26416,12675,13741,1253,4.7,9104,8661,443,26647,15309,3182,45,2876,1772
11730,5070,146190,172731,3358,14186,6939,7247,644,4.5,5230,5070,160,14376,12212,387,28,145,937
11731,10717,158819,183745,7977,29808,14729,15079,1305,4.4,11073,10717,356,29891,25090,623,0,1211,685
11732,1465,120707,173972,842,3546,1444,2102,270,7.6,1504,1465,39,3546,2876,50,0,30,91
11733,6073,174931,231243,4769,17045,8687,8358,782,4.6,6547,6073,474,17403,14023,288,35,1462,395
11735,11167,146190,170686,8180,32258,15888,16370,1332,4.1,11435,11167,268,32778,24636,1212,38,2592,1506
11738,5585,139008,162835,4587,19767,10676,9091,1139,5.8,5888,5585,303,20246,13450,2252,258,958,1610
11739,462,133393,175094,318,1191,537,654,5,0.4,508,462,46,1191,1033,0,0,29,0
11740,3650,161705,190011,2545,10447,5029,5418,602,5.8,3662,3650,12,10699,7863,1310,0,390,333
11741,8998,138417,155899,6675,26308,12669,13639,1298,4.9,9310,8998,312,26356,21968,912,0,1139,724
11742,4508,126563,149704,3489,13181,6509,6672,594,4.5,4610,4508,102,13194,10748,736,165,467,405
11743,15665,173014,231625,11257,42123,20988,21135,1726,4.1,16138,15665,473,42423,33087,1660,20,1968,1443
11746,21661,158309,202223,16509,66044,33824,32220,4578,6.9,22528,21661,867,66883,43647,4731,834,5514,5677
11747,7575,154914,215764,5003,19602,8982,10620,885,4.5,7871,7575,296,19826,16526,361,16,1149,340
11749,1241,112435,137764,973,3546,1740,1806,119,3.4,1324,1241,83,3581,1431,476,121,201,834
11751,5010,116328,132919,3356,13119,6447,6672,739,5.6,5246,5010,236,13152,10162,398,0,762,702
11752,3048,148538,161226,2465,8990,4531,4459,261,2.9,3180,3048,132,8990,6755,226,65,124,597
11753,3938,185000,255552,3273,12664,5928,6736,693,5.5,4132,3938,194,12729,5477,71,0,6253,133
11754,6821,123406,155500,4437,17447,8518,8929,376,2.2,7078,6821,257,17660,15511,135,70,553,241
11755,4052,120306,151853,3040,11880,6129,5751,690,5.8,4146,4052,94,11953,8837,118,13,1344,586
11756,13933,139901,153937,11581,42459,20867,21592,1468,3.5,14169,13933,236,42553,29291,945,23,5077,3108
11757,14350,128081,147067,10864,44290,22445,21845,2289,5.2,15212,14350,862,44571,33603,2404,33,1129,3242
11758,18802,157404,190361,14430,54604,26690,27914,2020,3.7,19297,18802,495,54741,45294,3200,17,873,1454
11762,7627,170799,184815,6353,22299,11083,11216,921,4.1,7783,7627,156,22447,20292,152,26,381,525
11763,9602,119286,131451,7039,29524,14534,14990,2005,6.8,10001,9602,399,30235,17853,3457,189,721,3641
11764,4212,142344,166719,3131,12489,6007,6482,792,6.3,4605,4212,393,12530,10572,72,0,384,435
11765,255,"250,000+",497758,229,808,422,386,35,4.3,276,255,21,808,727,0,0,54,0
11766,3863,157564,187628,3274,11475,5584,5891,218,1.9,4040,3863,177,11481,9727,213,7,439,257
11767,4898,148762,180385,3887,14288,7556,6732,504,3.5,4961,4898,63,14495,11861,466,181,851,115
11768,8213,163435,212862,6120,21748,10592,11156,1224,5.6,8581,8213,368,21908,19904,84,0,338,127
11769,3357,128419,169507,2242,8831,4300,4531,387,4.4,3783,3357,426,9031,7783,330,0,132,50
11770,52,101250,132213,34,124,82,42,0,0,1226,52,1174,124,91,0,0,0,0
11771,3700,163134,251140,2717,10158,4975,5183,811,8,4048,3700,348,10173,8093,238,0,503,385
11772,17246,105246,132359,10887,44695,21227,23468,2900,6.5,18478,17246,1232,45006,33008,2277,63,1449,4806
11776,8065,119480,139523,5755,23470,10634,12836,1492,6.4,8707,8065,642,23629,18074,1190,79,675,1715
11777,3628,148519,195559,2253,9221,4410,4811,458,5,3893,3628,265,9347,7669,99,23,586,320
11778,4768,119656,141807,3290,12914,6271,6643,293,2.3,5028,4768,260,12919,11018,83,15,112,145
11779,13091,117684,131977,9187,38148,19268,18880,2168,5.7,14145,13091,1054,38273,28943,1874,165,2535,1405
11780,5576,141576,199508,4120,15234,7253,7981,368,2.4,5907,5576,331,15586,13117,110,0,751,531
11782,5387,144786,176262,3814,14328,7086,7242,839,5.9,6680,5387,1293,14537,13152,80,0,169,128
11783,7090,164128,187341,5861,21517,10990,10527,619,2.9,7320,7090,230,21588,18912,571,36,826,476
11784,8441,105268,125416,6671,25956,13000,12956,1814,7,8759,8441,318,25986,17622,1148,116,1904,2001
11786,1895,161250,185873,1566,6342,3283,3059,129,2,1951,1895,56,6348,5480,99,0,172,222
11787,11834,141505,171981,8800,33958,16902,17056,1799,5.3,12147,11834,313,34656,29351,322,20,1733,465
11788,5581,148946,182787,4329,17028,8354,8674,772,4.5,5818,5581,237,17092,13329,221,8,1557,755
11789,2802,140665,133675,1861,7447,3439,4008,224,3,2888,2802,86,7447,6160,247,4,60,156
11790,4503,157695,200858,3400,12590,6433,6157,592,4.7,4856,4503,353,19934,12455,1173,50,5066,336
11791,8046,204357,269619,6826,25099,12498,12601,883,3.5,8316,8046,270,25194,14993,269,34,8258,488
11792,3044,147100,170299,2219,8520,4183,4337,216,2.5,3343,3044,299,8562,7685,101,20,76,373
11793,10430,168519,182371,8500,31349,15920,15429,1030,3.3,10774,10430,344,31497,26741,437,20,1073,685
11794,0,-,-,0,0,0,0,0,-,0,0,0,1519,369,174,7,743,47
11795,8026,171068,201669,6584,24776,12963,11813,583,2.4,8166,8026,140,25063,21064,312,16,473,463
11796,1273,162443,174164,1046,3709,1766,1943,62,1.7,1348,1273,75,3715,3347,73,0,112,65
11797,3162,183472,259936,2407,8408,4075,4333,479,5.7,3194,3162,32,9338,7275,162,0,1447,76
11801,12871,147945,170038,10591,41741,21251,20490,1464,3.5,13068,12871,197,41792,18464,766,167,13497,4249
11803,10324,184410,214552,8378,29999,14690,15309,975,3.3,10794,10324,470,30219,22678,101,50,5858,534
11804,1429,159145,206577,1251,4613,2292,2321,71,1.5,1521,1429,92,4613,3510,18,0,900,0
11901,11404,83252,103660,7641,31544,16115,15429,4687,14.9,13126,11404,1722,32921,19138,3597,67,872,4628
11930,316,132917,228393,212,689,309,380,5,0.7,1970,316,1654,689,620,2,0,0,30
11931,11,-,N,11,24,13,11,0,0,11,11,0,24,24,0,0,0,0
11932,313,200353,380717,207,696,395,301,7,1,1701,313,1388,696,580,70,0,0,6
11933,3069,80571,107286,1746,6767,3581,3186,421,6.2,3704,3069,635,6784,5436,567,0,94,573
11934,2750,154588,168159,2166,8128,3806,4322,325,4,2819,2750,69,8222,7356,198,0,145,243
11935,1199,138024,199548,885,2902,1489,1413,154,5.3,2018,1199,819,2946,2722,2,0,15,25
11937,8633,122489,194670,5826,21790,10244,11546,2909,13.4,14277,8633,5644,21806,14491,445,73,415,1408
11939,751,116023,168424,531,1741,758,983,32,1.8,1222,751,471,1741,1646,9,0,8,40
11940,2051,121250,166266,1395,5494,2839,2655,195,3.5,2212,2051,161,5508,4944,86,0,18,163
11941,887,124095,165792,749,2472,1209,1263,156,6.3,1019,887,132,2472,1691,68,0,30,149
11942,2399,106875,155498,1486,5802,2699,3103,750,12.9,3471,2399,1072,5871,5178,9,49,124,380
11944,2043,79917,141687,1213,4550,2242,2308,428,9.4,3106,2043,1063,4744,3398,169,7,101,764
11946,6503,128844,170074,4534,17285,9179,8106,1509,8.7,9098,6503,2595,17303,12253,273,78,444,2055
11947,100,-,N,31,248,114,134,0,0,100,100,0,248,248,0,0,0,0
11948,303,146054,159335,187,775,394,381,0,0,667,303,364,775,771,4,0,0,0
11949,4998,135000,155687,3622,13145,6820,6325,891,6.8,5162,4998,164,13159,11389,335,0,411,92
11950,4753,105593,134176,3907,16846,8601,8245,1428,8.5,5039,4753,286,16944,11517,1488,255,249,883
11951,4953,108877,115879,3745,15780,6946,8834,3511,22.2,5352,4953,399,15830,12199,1109,4,405,634
11952,2044,116667,157270,1503,4749,2283,2466,374,7.9,2773,2044,729,4749,4458,35,0,41,136
11953,5410,92049,106732,3234,13078,6349,6729,1407,10.8,5848,5410,438,13383,9693,2171,36,105,377
11954,1618,129375,214849,982,4019,2147,1872,236,5.9,4565,1618,2947,4073,3711,55,7,2,121
11955,1402,77692,85769,724,2626,1248,1378,402,15.3,1626,1402,224,2626,2245,187,4,0,29
11956,142,121500,139252,90,293,143,150,19,6.5,291,142,149,293,271,0,0,2,17
11957,656,88293,157991,296,1152,524,628,48,4.2,1095,656,439,1152,1102,8,0,5,30
11958,321,64263,102928,235,864,513,351,0,0,558,321,237,864,710,0,0,0,69
11959,240,-,156518,203,576,228,348,198,34.4,1377,240,1137,576,426,15,0,0,1
11960,429,216989,343758,336,1037,474,563,0,0,1118,429,689,1037,1037,0,0,0,0
11961,5575,86134,118600,3043,12362,5718,6644,458,3.7,6142,5575,567,12436,11034,495,9,255,350
11962,265,89886,354146,132,546,244,302,111,20.3,942,265,677,546,437,46,0,3,0
11963,3543,126513,223835,2457,8114,3999,4115,273,3.4,6304,3543,2761,8114,6481,133,68,288,236
11964,1096,129826,148647,707,2832,1346,1486,105,3.7,2483,1096,1387,2858,1779,25,430,173,238
11965,285,-,152498,117,421,165,256,82,19.5,789,285,504,421,414,2,0,0,5
11967,8486,106810,155532,6556,26879,13878,13001,2114,7.9,8922,8486,436,27266,18873,2682,60,1194,2147
11968,5539,146138,273942,3633,13954,6882,7072,732,5.2,10444,5539,4905,14263,10331,1238,273,393,617
11970,224,-,285600,224,468,266,202,0,0,423,224,199,468,425,0,0,0,0
11971,2637,124097,188631,1824,6464,3265,3199,225,3.5,3963,2637,1326,6507,5300,54,0,256,560
11972,125,-,133270,105,309,11,298,104,33.7,240,125,115,309,305,2,0,0,0
11973,0,-,-,0,0,0,0,0,-,73,0,73,42,5,0,0,24,0
11975,210,-,301662,108,423,244,179,84,19.9,662,210,452,423,327,21,0,9,5
11976,1140,158000,273184,778,2447,1118,1329,99,4,2550,1140,1410,2447,2175,12,0,49,2
11977,1021,156406,197773,813,2660,1149,1511,31,1.2,1594,1021,573,2782,2513,6,0,90,119
11978,1623,108938,215003,1155,4376,2246,2130,432,9.9,3936,1623,2313,4376,3229,254,0,80,214
11980,2416,106857,117356,1182,5121,2541,2580,217,4.2,2467,2416,51,5138,4541,256,22,90,41
12007,136,99688,119966,87,314,204,110,26,8.3,136,136,0,314,312,2,0,0,0
12008,201,140594,132513,166,610,360,250,1,0.2,201,201,0,610,520,0,0,0,0
12009,3122,114352,138133,2118,8068,3978,4090,264,3.3,3238,3122,116,8068,6816,226,5,552,39
12010,11277,60013,78434,6657,26927,13536,13391,4395,16.3,13436,11277,2159,27339,20152,1326,130,400,2781
12015,1518,84342,115472,1002,4084,2023,2061,557,13.6,2244,1518,726,4084,3416,54,0,129,69
12017,214,-,148618,109,439,199,240,5,1.1,318,214,104,439,402,0,0,2,19
12018,2836,133542,152763,2094,7069,3719,3350,175,2.5,3123,2836,287,7069,6720,1,0,49,0
12019,6559,116329,152691,4336,15651,7871,7780,486,3.1,6911,6559,352,15683,13984,209,4,644,154
12020,14473,101727,118817,8913,33587,16756,16831,2108,6.3,15787,14473,1314,34140,31128,630,22,646,293
12022,401,77386,97228,224,1069,505,564,132,12.3,455,401,54,1069,1022,10,0,3,15
12023,824,115658,119212,678,2356,1189,1167,89,3.8,906,824,82,2364,2270,0,0,0,0
12024,45,-,124024,29,80,44,36,14,17.5,45,45,0,80,80,0,0,0,0
12025,2347,71732,97187,1440,5272,2639,2633,521,9.9,3211,2347,864,5278,4773,44,0,64,45
12027,1690,106500,128662,1350,4693,2059,2634,247,5.3,1715,1690,25,4706,4306,11,2,49,79
12028,387,87266,95651,293,1132,648,484,206,18.2,399,387,12,1132,1132,0,0,0,0
12029,492,104167,122000,270,929,439,490,57,6.1,755,492,263,1017,928,48,0,1,6
12031,86,83056,99114,59,224,127,97,13,5.8,110,86,24,224,188,0,0,0,0
12032,354,54375,73130,221,707,294,413,56,7.9,1302,354,948,710,694,3,0,0,0
12033,3507,92808,108459,2093,7704,3760,3944,400,5.2,3843,3507,336,7772,7113,120,72,5,92
12035,202,78333,109380,139,455,227,228,0,0,227,202,25,455,438,15,0,0,0
12036,96,41667,67104,45,335,153,182,32,9.6,192,96,96,335,237,0,0,0,7
12037,1727,93990,117435,1006,4045,1893,2152,549,13.6,2035,1727,308,4045,3399,36,0,26,92
12040,20,55682,54370,0,29,25,4,9,31,20,20,0,29,29,0,0,0,0
12041,162,117557,121159,109,353,171,182,0,0,162,162,0,353,353,0,0,0,0
12042,111,-,159058,58,286,136,150,0,0,111,111,0,286,279,0,0,0,0
12043,2930,73006,90861,1756,6709,3329,3380,904,13.5,3292,2930,362,7883,6821,211,11,137,316
12045,138,116827,146522,85,237,122,115,1,0.4,234,138,96,237,215,22,0,0,0
12046,272,79833,95406,185,612,299,313,52,8.5,291,272,19,612,565,0,0,0,0
12047,9756,66970,95283,5525,22662,10498,12164,4638,20.5,10963,9756,1207,23406,16729,2572,17,1225,256
12051,1503,88393,109115,971,3848,1957,1891,169,4.4,1732,1503,229,5706,4272,1091,18,5,45
12052,705,116250,101363,518,1931,885,1046,113,5.9,876,705,171,1931,1825,0,0,0,16
12053,1821,99831,133318,1175,4321,2325,1996,404,9.3,1997,1821,176,4325,3711,77,0,1,69
12054,7030,128684,151751,4598,16768,8087,8681,385,2.3,7221,7030,191,16988,15756,71,4,377,140
12056,789,117652,131908,571,1818,919,899,102,5.6,805,789,16,1818,1764,4,0,0,0
12057,773,66958,85057,498,1966,1120,846,70,3.6,854,773,81,1966,1834,0,0,28,26
12058,588,84865,95977,437,1449,872,577,242,16.7,823,588,235,1451,1274,71,0,0,65
12059,672,100938,114413,516,1531,804,727,35,2.3,1020,672,348,1531,1480,0,0,9,14
12060,787,102109,161964,622,1766,902,864,60,3.4,987,787,200,1768,1616,0,0,20,42
12061,3984,117083,151711,2702,9482,5013,4469,134,1.4,4144,3984,160,9778,8241,300,0,498,209
12062,764,86094,101732,437,1723,950,773,168,9.8,865,764,101,1723,1593,0,0,24,0
12063,299,84817,112855,224,745,271,474,51,6.8,299,299,0,745,721,0,0,0,0
12064,123,69792,71728,60,311,157,154,8,2.6,275,123,152,314,244,0,0,1,1
12065,18206,115681,147862,11836,44555,21838,22717,1358,3,19506,18206,1300,44726,36786,1107,46,3349,422
12066,770,71250,92652,513,1825,891,934,105,5.8,864,770,94,1830,1650,2,0,4,10
12067,498,120878,123880,365,1250,461,789,87,7,554,498,56,1250,1194,21,0,0,0
12068,1000,73050,88321,628,2695,1158,1537,288,10.7,1138,1000,138,2717,2587,15,0,0,12
12069,117,-,140881,75,387,176,211,0,0,117,117,0,387,350,37,0,0,0
12070,771,78884,101963,535,2399,1326,1073,346,14.4,790,771,19,2404,2360,0,5,26,0
12071,99,69013,92989,73,221,116,105,12,5.4,128,99,29,221,217,0,0,0,4
12072,979,86442,98871,671,2944,1422,1522,486,16.5,1186,979,207,3019,2794,26,1,8,8
12074,1187,91901,108237,836,2826,1563,1263,373,13.2,1577,1187,390,2833,2666,0,0,15,89
12075,1076,83443,141880,802,3015,1462,1553,362,12,1348,1076,272,3147,2573,101,3,0,313
12076,578,73056,93172,404,1316,673,643,117,8.9,1162,578,584,1316,1088,14,0,21,112
12077,2668,125370,148209,1751,6729,3187,3542,681,10.1,2742,2668,74,6733,5649,335,7,431,134
12078,9845,54565,68404,6177,22705,11114,11591,4467,19.7,11668,9845,1823,23087,20107,419,0,252,509
12082,3,-,N,0,3,3,0,0,0,3,3,0,3,0,0,0,0,0
12083,1225,84004,107814,906,3528,1687,1841,126,3.6,1492,1225,267,3648,3333,1,0,93,156
12084,2211,86968,116372,1340,4857,2615,2242,456,9.4,2332,2211,121,5054,3000,411,0,1424,5
12085,112,-,64296,22,195,123,72,13,6.7,145,112,33,309,279,5,0,0,0
12086,699,81556,81484,367,1644,679,965,65,4,864,699,165,1644,1576,0,5,8,17
12087,608,89375,108691,519,1678,830,848,58,3.5,699,608,91,1678,1452,0,0,6,0
12090,2262,72500,82533,1491,5786,2691,3095,490,8.5,2714,2262,452,5874,5574,21,0,0,190
12092,641,70938,91555,390,1423,784,639,191,13.4,705,641,64,1423,1250,87,0,0,0
12093,592,61250,95466,365,1258,688,570,160,12.7,1107,592,515,1258,1105,0,0,15,0
12094,826,101087,120069,679,2560,1249,1311,269,10.5,846,826,20,2560,2402,0,0,0,0
12095,5290,69864,80901,3185,11457,5775,5682,882,7.7,5808,5290,518,12013,10934,312,0,81,192
12106,952,80735,117618,541,1963,1005,958,232,11.8,1053,952,101,1963,1830,0,0,19,55
12108,170,76786,78375,116,368,186,182,31,8.4,703,170,533,396,316,24,0,0,0
12110,8014,101839,117113,4928,19431,9646,9785,1503,7.7,8269,8014,255,19969,15141,999,0,2256,283
12115,41,187841,152037,8,62,42,20,0,0,73,41,32,62,62,0,0,0,0
12116,616,76359,114613,396,1533,575,958,134,8.7,930,616,314,1533,1504,0,0,0,0
12117,1281,66685,121165,784,2824,1410,1414,368,13,1767,1281,486,2841,2640,7,0,0,3
12118,7526,91182,122860,4521,17038,8657,8381,1415,8.3,8079,7526,553,17056,15200,78,64,556,199
12120,241,76728,118218,158,589,272,317,9,1.5,313,241,72,596,579,0,0,0,0
12121,722,120625,128730,608,2274,1207,1067,77,3.4,798,722,76,2325,2252,18,0,0,0
12122,1737,54308,77089,1016,3555,1792,1763,372,10.5,2395,1737,658,3555,3276,24,0,20,0
12123,2071,104438,122913,1312,4816,2429,2387,349,7.2,2346,2071,275,4853,4531,14,0,12,31
12124,116,-,85075,51,168,96,72,4,2.4,140,116,24,182,182,0,0,0,0
12125,449,67596,98682,250,1116,540,576,147,13.2,619,449,170,1147,1012,0,0,27,25
12130,133,101339,94026,84,305,114,191,9,3,229,133,96,305,305,0,0,0,0
12131,90,58929,83424,53,209,97,112,29,13.9,143,90,53,209,200,0,1,0,0
12132,93,-,129741,13,129,74,55,0,0,103,93,10,129,129,0,0,0,0
12134,1747,70938,93237,1126,4084,2112,1972,611,15,2906,1747,1159,4093,3844,0,0,4,17
12136,370,155978,236304,315,881,498,383,32,3.6,536,370,166,881,840,23,0,0,0
12137,847,96678,108126,577,2347,1057,1290,351,15,907,847,60,2347,2163,66,0,0,86
12138,1173,78693,89976,741,2819,1457,1362,213,7.6,1661,1173,488,2826,2582,25,1,18,18
12139,116,91250,85674,61,243,110,133,13,5.3,656,116,540,243,217,0,0,0,0
12140,620,120476,125776,463,1526,697,829,150,9.8,646,620,26,1526,1440,1,0,31,0
12143,2166,89450,111531,1362,5428,2591,2837,451,8.3,2523,2166,357,5462,4933,167,0,90,159
12144,9552,88357,100516,5227,21415,10522,10893,2519,11.8,10474,9552,922,21631,16808,1271,6,1473,445
12147,227,92813,110841,151,508,211,297,25,4.9,323,227,96,508,490,0,0,13,0
12148,1810,135694,180243,1226,4121,2049,2072,173,4.2,1949,1810,139,4121,3681,68,0,179,0
12149,946,58750,70268,542,2165,1025,1140,216,10,1318,946,372,2176,2055,27,4,0,15
12150,283,73977,75723,144,665,299,366,14,2.1,323,283,40,665,610,14,0,0,0
12151,438,96184,116129,291,962,468,494,24,2.5,496,438,58,986,906,20,0,47,0
12153,339,85347,119442,218,751,396,355,159,21.2,506,339,167,751,751,0,0,0,0
12154,1223,110387,123213,953,2875,1441,1434,255,8.9,1280,1223,57,2875,2805,10,5,0,0
12155,711,61563,77861,477,1812,876,936,144,7.9,1007,711,296,1812,1647,9,2,0,15
12156,318,99833,114876,222,902,485,417,75,8.3,318,318,0,939,923,16,0,0,0
12157,1755,77364,102794,1157,4348,2272,2076,323,7.4,1853,1755,98,4444,3984,65,12,91,1
12158,2767,95949,118322,1871,6221,3261,2960,204,3.3,3205,2767,438,6221,5346,80,0,0,205
12159,3825,109073,159523,2499,8679,4065,4614,416,4.8,3980,3825,155,8794,7351,259,0,670,67
12160,338,70833,79860,173,730,376,354,61,8.4,421,338,83,735,711,0,0,5,0
12161,23,-,N,11,41,9,32,0,0,23,23,0,41,41,0,0,0,0
12164,225,58594,78921,141,520,252,268,89,17.1,787,225,562,520,503,0,0,8,0
12165,116,53500,82833,41,202,128,74,27,13.4,135,116,19,202,202,0,0,0,0
12166,554,90147,89279,419,1454,780,674,80,5.5,677,554,123,1459,1347,15,0,1,0
12167,965,58950,73611,548,2156,1067,1089,409,19,1486,965,521,2257,2127,9,0,15,11
12168,680,86028,103282,416,1632,805,827,9,0.6,793,680,113,1691,1535,30,0,0,59
12169,209,39921,70745,81,406,206,200,0,0,226,209,17,407,398,0,0,0,0
12170,2073,100469,113129,1656,5225,2519,2706,542,10.4,2327,2073,254,5225,4732,70,4,9,110
12172,56,62000,70023,56,184,105,79,0,0,62,56,6,184,184,0,0,0,0
12173,734,80500,93362,564,2040,1052,988,195,9.6,835,734,101,2040,1791,24,0,0,178
12174,250,50882,57920,160,571,292,279,85,14.9,258,250,8,571,542,0,0,0,26
12175,296,88409,90044,206,725,377,348,27,3.7,620,296,324,725,610,4,0,0,78
12176,155,49250,57414,81,410,98,312,0,0,224,155,69,431,216,0,0,14,102
12177,146,89890,123583,63,361,122,239,0,0,146,146,0,361,302,0,0,0,0
12180,21967,73767,97003,10921,48928,24421,24507,8286,16.9,25527,21967,3560,54071,38525,6720,122,2651,1962
12182,6604,54663,73374,3578,14168,6491,7677,3420,24.1,7314,6604,710,14273,10016,2226,0,110,273
12183,1485,70281,86205,470,2952,1410,1542,685,23.2,1758,1485,273,2966,2155,280,0,35,246
12184,2917,91616,129076,2037,7333,3579,3754,520,7.1,3415,2917,498,7547,6744,21,8,55,55
12185,687,111691,120563,513,1699,969,730,88,5.2,726,687,39,1699,1666,0,1,6,0
12186,2630,116053,144309,1867,6608,3376,3232,427,6.5,2718,2630,88,6608,6115,12,1,57,114
12187,292,75875,90083,172,727,349,378,141,19.4,450,292,158,739,722,9,0,0,8
12188,4916,87212,107803,3206,11386,5677,5709,624,5.5,5197,4916,281,11414,10182,374,189,138,58
12189,8681,62763,84110,4212,18195,8413,9782,2775,15.3,9887,8681,1206,18205,13315,1419,0,1445,539
12190,239,55568,83221,196,683,331,352,29,4.2,746,239,507,683,659,0,0,0,13
12192,491,74293,85568,299,1033,644,389,105,10.2,598,491,107,1033,957,5,0,0,54
12193,887,76438,102022,581,1829,995,834,193,10.6,1104,887,217,1829,1749,24,0,13,0
12194,70,81250,78146,64,213,96,117,23,10.8,149,70,79,213,213,0,0,0,0
12195,81,143817,148268,14,155,67,88,0,0,81,81,0,155,155,0,0,0,0
12196,1301,126825,142785,1153,3848,1765,2083,147,3.8,1308,1301,7,3848,3745,4,0,5,16
12197,780,78750,88846,571,2273,1147,1126,416,18.3,1222,780,442,2275,1897,12,6,0,176
12198,2933,113042,132623,2234,7320,3463,3857,346,4.7,3069,2933,136,7337,6621,44,0,92,164
12202,4559,49684,63250,1929,9455,4805,4650,2446,25.9,5434,4559,875,9500,2836,4113,43,641,562
12203,13472,80055,102643,5661,27489,13492,13997,4074,14.8,14755,13472,1283,30080,21227,3142,9,2485,1161
12204,3933,75197,88886,1796,8415,4025,4390,1184,14.1,4290,3933,357,8423,4222,2459,22,687,374
12205,11496,89270,103518,6455,25871,12644,13227,1633,6.3,12061,11496,565,25912,19793,2070,2,2209,204
12206,6451,38931,56502,2813,14527,7499,7028,5486,37.8,8641,6451,2190,14592,4225,6178,43,1516,840
12207,1288,32418,57696,199,2073,1195,878,901,43.5,1553,1288,265,2097,953,933,0,64,86
12208,10596,69505,92510,4354,22325,10207,12118,4605,20.6,11522,10596,926,23936,16373,3037,52,2340,543
12209,4485,81642,92030,2473,10660,5243,5417,1134,10.6,4768,4485,283,10754,5654,2702,0,825,807
12210,5366,55873,70650,1881,9560,5003,4557,2099,22,6580,5366,1214,9725,4432,4170,0,274,141
12211,4321,145709,203143,3074,11110,5384,5726,422,3.8,4561,4321,240,13800,10594,685,0,1368,188
12222,54,59274,71937,5,64,54,10,0,0,54,54,0,6494,3750,1445,25,436,363
12226,0,-,-,0,0,0,0,0,-,0,0,0,0,0,0,0,0,0
12302,11491,94156,111527,7168,26977,13080,13897,1162,4.3,12406,11491,915,27470,25076,426,58,465,145
12303,11786,77615,99099,7593,29731,14458,15273,4762,16,12533,11786,747,29989,20182,3406,6,1343,1613
12304,9210,67688,88246,5380,21780,10504,11276,4440,20.4,9438,9210,228,22027,11788,3995,104,2156,1157
12305,3754,50308,71286,1012,6638,3461,3177,1114,16.8,4103,3754,349,7764,4720,1556,19,183,226
12306,11697,80583,94565,6854,27565,13725,13840,2157,7.8,12481,11697,784,27569,22003,2102,9,795,562
12307,3137,33191,46040,1918,7977,4006,3971,2714,34,3491,3137,354,7977,1676,2366,208,961,1527
12308,5955,59789,87107,2739,12297,6018,6279,2187,17.8,6442,5955,487,13985,8398,2771,112,379,1261
12309,12837,119830,141641,8804,32623,16479,16144,1413,4.3,13623,12837,786,32996,25439,1328,106,2997,488
12401,15150,67426,93640,7902,34505,16984,17521,5927,17.2,16914,15150,1764,35058,24882,3733,515,686,1787
12404,1694,67297,114313,1132,4046,1784,2262,683,16.9,2512,1694,818,4046,3326,13,0,26,218
12405,210,68000,85685,90,449,230,219,66,14.7,486,210,276,449,429,0,0,0,0
12406,328,65643,101405,161,609,374,235,105,17.2,653,328,325,609,385,0,223,0,0
12407,66,83409,95941,34,197,109,88,8,4.1,66,66,0,197,186,11,0,0,0
12409,442,114758,137809,300,877,431,446,60,6.8,625,442,183,877,741,0,0,37,67
12410,253,31033,47394,48,379,226,153,146,38.5,559,253,306,379,379,0,0,0,0
12411,157,81625,118685,95,288,133,155,0,0,185,157,28,288,276,0,0,12,0
12412,260,77988,85259,188,603,367,236,91,15.1,260,260,0,603,558,0,0,33,0
12413,1416,53958,81743,701,3375,1513,1862,440,13,1807,1416,391,3406,3095,20,0,0,68
12414,4108,66022,94594,2365,9724,4954,4770,1138,11.7,5342,4108,1234,10034,8045,724,0,95,344
12416,86,-,130214,6,129,100,29,0,0,209,86,123,129,79,0,6,9,0
12417,392,132578,149900,258,984,441,543,12,1.2,437,392,45,984,782,0,0,0,0
12418,149,97750,139048,100,321,181,140,28,8.7,450,149,301,321,274,13,0,0,0
12419,396,119268,166942,311,1115,549,566,31,2.8,421,396,25,1115,940,7,0,0,0
12420,129,108250,98373,120,435,219,216,0,0,188,129,59,435,435,0,0,0,0
12421,135,97545,113264,82,238,140,98,23,9.7,455,135,320,238,238,0,0,0,0
12422,225,62321,87384,138,469,181,288,76,16.2,426,225,201,469,449,0,0,20,0
12423,402,77672,77226,283,1033,586,447,80,7.7,690,402,288,1033,701,0,0,0,0
12424,166,60517,80463,51,242,175,67,9,3.7,438,166,272,242,223,0,0,0,0
12427,125,73917,105630,87,832,336,496,247,29.7,366,125,241,926,908,7,0,4,7
12428,2789,78802,88133,1708,6965,3387,3578,1431,20.5,3762,2789,973,6972,5274,289,35,46,695
12429,56,-,N,0,168,149,19,112,66.7,56,56,0,168,44,105,0,0,0
12430,531,66637,100611,348,1171,442,729,129,11,1236,531,705,1232,1061,0,15,19,19
12431,652,88750,110889,543,1668,854,814,42,2.5,900,652,248,1705,1546,0,56,27,0
12432,289,45591,59962,171,654,281,373,248,37.9,289,289,0,654,418,0,0,0,0
12433,199,63380,95773,172,525,245,280,138,26.3,366,199,167,525,482,0,0,13,0
12434,405,48558,80821,180,892,433,459,51,5.7,550,405,145,892,825,23,0,0,0
12435,68,84479,82293,60,181,105,76,8,4.4,196,68,128,181,167,0,0,0,0
12436,245,99871,85380,182,516,253,263,39,7.6,355,245,110,516,516,0,0,0,0
12438,26,49000,56446,26,71,26,45,21,29.6,57,26,31,71,71,0,0,0,0
12439,151,88958,96432,125,380,213,167,24,6.3,547,151,396,380,337,11,0,0,0
12440,675,102958,119335,392,1572,777,795,185,11.8,865,675,190,1577,1362,8,0,13,176
12441,47,56509,193732,11,58,39,19,0,0,208,47,161,58,58,0,0,0,0
12442,216,50500,81185,136,425,200,225,38,8.9,1310,216,1094,425,396,0,0,0,14
12443,1576,97981,132685,1090,3565,1631,1934,168,4.7,1772,1576,196,3601,3027,123,0,95,86
12444,164,55000,83224,100,519,333,186,45,8.7,477,164,313,519,307,0,0,0,14
12446,2180,83344,116497,1627,5219,2525,2694,514,9.8,2775,2180,595,5232,4382,135,28,69,62
12448,84,196964,205888,53,163,111,52,10,6.1,210,84,126,163,163,0,0,0,0
12449,1095,75268,96615,669,2493,1273,1220,256,10.3,1194,1095,99,2916,2250,157,0,38,201
12450,89,126845,164480,80,200,100,100,27,13.5,140,89,51,200,187,0,0,0,0
12451,408,54615,65122,191,849,416,433,90,10.6,545,408,137,849,796,0,0,53,0
12452,19,-,N,14,33,19,14,0,0,19,19,0,33,33,0,0,0,0
12453,91,-,N,91,212,91,121,0,0,197,91,106,212,212,0,0,0,0
12454,131,104306,137956,98,368,203,165,5,1.4,308,131,177,368,335,0,0,10,0
12455,895,74271,83137,543,1786,949,837,169,9.5,1697,895,802,1859,1541,15,0,14,81
12456,291,92585,91853,207,666,403,263,32,4.8,291,291,0,666,643,0,0,0,13
12457,509,73949,125709,280,1171,576,595,69,5.9,615,509,106,1171,1076,13,0,0,17
12458,857,65547,83951,512,2021,1097,924,161,8,985,857,128,3195,1841,681,9,0,371
12459,37,107875,147535,27,73,35,38,0,0,155,37,118,73,73,0,0,0,0
12460,119,-,90299,41,161,87,74,0,0,161,119,42,161,161,0,0,0,0
12461,673,95545,182659,336,1418,751,667,225,15.9,903,673,230,1426,1197,0,0,0,0
12463,727,45993,85797,275,1531,600,931,470,30.7,825,727,98,1531,1465,0,0,0,0
12464,588,75291,84361,261,1024,598,426,292,28.5,972,588,384,1071,826,21,0,44,41
12465,159,84141,115581,88,329,220,109,38,11.6,273,159,114,329,221,0,0,106,0
12466,804,91875,137018,522,1937,1086,851,208,10.7,884,804,80,1947,1459,95,0,0,119
12468,636,60556,90884,378,1401,748,653,182,13,1262,636,626,1413,1303,26,2,26,0
12469,399,89844,100532,203,842,471,371,14,1.7,720,399,321,842,791,33,0,13,0
12470,242,84155,89402,46,612,232,380,110,18,321,242,79,651,651,0,0,0,0
12471,274,"2,500-",17835,0,274,23,251,206,75.2,274,274,0,274,274,0,0,0,0
12472,643,67770,93288,339,1118,580,538,81,7.2,759,643,116,1118,913,47,0,25,9
12473,248,100167,125585,190,693,347,346,61,8.8,428,248,180,693,665,0,0,0,0
12474,450,54462,81486,266,891,389,502,72,8.1,1015,450,565,891,788,8,0,0,19
12475,271,79402,87121,166,569,426,143,27,4.7,271,271,0,569,393,0,0,7,84
12477,8321,72353,104384,4762,18714,9155,9559,1485,7.9,9483,8321,1162,18789,15710,266,116,107,321
12480,207,64784,120048,136,499,285,214,55,11,394,207,187,499,382,0,0,22,0
12481,555,93578,126653,342,1359,692,667,173,12.7,555,555,0,1359,1263,0,0,35,23
12482,229,-,71726,94,601,302,299,89,14.8,276,229,47,601,582,6,0,0,0
12483,38,-,58466,15,59,21,38,19,32.2,129,38,91,59,55,0,0,0,0
12484,1371,116023,154525,1047,3226,1449,1777,365,11.3,1479,1371,108,3271,2709,245,0,85,0
12485,262,85455,120532,189,1136,507,629,186,16.4,815,262,553,1136,900,8,0,0,222
12486,652,83333,90864,356,1737,826,911,203,11.7,689,652,37,1737,1060,153,0,10,511
12487,1500,92847,111225,811,3699,1939,1760,460,12.4,1693,1500,193,3829,2866,495,0,7,0
12489,72,26100,24343,22,114,22,92,25,21.9,81,72,9,114,114,0,0,0,0
12490,0,-,-,0,0,0,0,0,-,0,0,0,0,0,0,0,0,0
12491,813,71963,111047,481,2006,981,1025,304,15.2,935,813,122,2017,1616,7,5,0,70
12492,114,125313,179925,47,213,124,89,11,5.2,314,114,200,213,203,0,0,0,0
12493,75,-,171444,0,318,278,40,139,43.7,163,75,88,343,259,25,0,5,3
12494,341,140750,161266,277,876,500,376,0,0,638,341,297,876,754,0,0,15,107
12495,175,-,75725,56,229,146,83,0,0,229,175,54,229,229,0,0,0,0
12496,573,68173,130282,332,1237,582,655,115,9.3,2006,573,1433,1241,1086,61,0,26,0
12498,2371,80221,117469,1130,4521,2196,2325,619,13.7,2926,2371,555,4530,3882,87,0,139,188
12501,1002,78716,120774,665,2334,1204,1130,185,7.9,1062,1002,60,2374,1584,0,0,93,366
12502,423,83583,141780,314,958,521,437,58,6.1,599,423,176,1019,885,14,0,8,2
12503,282,104375,130632,185,743,352,391,57,7.7,530,282,248,750,537,12,0,2,132
12504,0,-,-,0,0,0,0,0,-,0,0,0,1057,665,112,13,106,90
12507,86,113793,150331,67,237,100,137,6,2.5,86,86,0,279,232,7,0,8,0
12508,8367,88510,115028,4559,17880,8561,9319,1474,8.2,8798,8367,431,19519,13271,2636,101,319,1468
12512,115,96151,170929,77,232,113,119,0,0,139,115,24,232,223,0,0,0,9
12513,144,59167,73068,40,198,119,79,0,0,196,144,52,198,198,0,0,0,0
12514,1358,115147,184510,977,3120,1575,1545,160,5.1,1556,1358,198,3120,2959,36,0,43,18
12515,550,-,108392,407,1483,762,721,70,4.7,681,550,131,1483,1063,47,0,0,0
12516,708,126667,182741,461,1742,896,846,161,9.2,990,708,282,1748,1592,23,0,18,31
12517,108,143250,141494,78,270,117,153,41,15.2,158,108,50,270,214,0,0,0,46
12518,2340,99833,117260,1524,5722,2742,2980,390,6.8,2474,2340,134,5728,4586,60,0,299,361
12520,1242,150144,167257,897,3051,1472,1579,80,2.6,1359,1242,117,3088,2661,88,0,39,164
12521,801,85208,123716,588,1874,872,1002,163,8.7,1326,801,525,1874,1529,22,0,9,100
12522,1791,82636,101596,1296,5074,2380,2694,685,13.5,2135,1791,344,5074,4228,51,12,120,169
12523,1032,54128,90018,604,2127,1101,1026,401,18.9,1315,1032,283,2132,1963,14,0,14,8
12524,6437,95713,120268,3742,14249,6845,7404,620,4.4,6702,6437,265,15079,11847,954,63,509,402
12525,654,103417,161700,363,1703,806,897,103,6,976,654,322,1710,1218,18,0,0,13
12526,1519,87107,113352,981,3427,1721,1706,320,9.3,1838,1519,319,3427,2974,116,0,24,24
12527,19,-,N,19,42,23,19,0,0,19,19,0,42,19,23,0,0,0
12528,5771,89096,124370,3221,13429,6550,6879,710,5.3,6332,5771,561,13818,10448,466,0,1010,673
12529,1103,79531,162308,673,2325,1216,1109,240,10.3,1754,1103,651,2345,2167,18,0,0,33
12530,42,-,N,42,218,49,169,0,0,42,42,0,218,218,0,0,0,0
12531,901,126319,180600,592,2225,1226,999,35,1.6,1085,901,184,2316,1771,77,48,44,151
12533,8800,134950,176660,7291,26770,13622,13148,1256,4.7,9419,8800,619,26770,18786,1287,98,1591,1588
12534,7855,76086,109577,4893,16806,8495,8311,2776,16.5,9613,7855,1758,17468,13214,1243,88,1132,529
12538,5382,86641,109823,3405,12385,6220,6165,1277,10.3,5609,5382,227,14104,11227,1286,19,410,481
12540,3173,107436,154173,2593,9307,4495,4812,531,5.7,3318,3173,145,9314,7157,461,5,252,506
12542,2265,123517,160898,1647,5791,2980,2811,232,4,2459,2265,194,5859,4651,298,28,35,182
12543,1401,89293,95309,775,3147,1451,1696,231,7.3,1519,1401,118,3147,1886,538,30,59,81
12544,22,-,N,22,54,32,22,0,0,22,22,0,54,54,0,0,0,0
12545,2093,77991,159221,979,4253,2001,2252,543,12.8,2492,2093,399,4389,3836,79,8,103,29
12546,1191,88603,132499,763,2689,1292,1397,307,11.4,1594,1191,403,2710,1944,115,114,68,315
12547,1256,87727,133932,693,2791,1476,1315,555,19.9,1358,1256,102,2808,1944,295,0,32,170
12548,333,114191,130036,245,980,470,510,71,7.2,354,333,21,1039,900,0,0,0,0
12549,3714,125000,158254,2683,10812,5175,5637,686,6.3,3918,3714,204,10896,7884,1183,41,19,485
12550,20116,78019,97604,13320,54141,26357,27784,9314,17.2,22204,20116,2088,54996,23547,11515,505,1143,11655
12553,10620,94207,121678,7288,26994,13006,13988,1682,6.2,11150,10620,530,27300,16649,3833,125,1296,2806
12561,6444,89694,120569,3046,15562,7474,8088,3351,21.5,7081,6444,637,18531,13979,1332,70,767,632
12563,2197,102472,131399,1758,6879,3559,3320,1461,21.2,2276,2197,79,7456,5612,664,0,137,581
12564,2895,111683,153867,1956,7675,3907,3768,351,4.6,3169,2895,274,7910,6076,278,0,103,590
12565,570,62972,100767,384,1456,867,589,129,8.9,744,570,174,1575,1247,260,0,6,0
12566,4069,110154,126195,2792,11675,5345,6330,824,7.1,4454,4069,385,11718,9325,303,0,176,557
12567,1083,95982,154622,730,2498,1323,1175,290,11.6,1434,1083,351,2498,2156,15,1,38,51
12569,4043,113902,130197,2692,9672,4742,4930,411,4.2,4266,4043,223,9766,8168,288,22,138,270
12570,2166,127396,174260,1718,6324,3224,3100,329,5.2,2252,2166,86,6324,5021,399,0,205,170
12571,4044,115200,155900,2682,10071,4965,5106,533,5.3,4454,4044,410,10168,8886,269,6,174,71
12572,4273,96377,142133,2331,8723,4192,4531,639,7.3,4785,4273,512,9168,7974,152,0,197,339
12574,196,-,98999,110,422,216,206,26,6.2,241,196,45,422,330,92,0,0,0
12575,553,147950,146616,445,1743,999,744,132,7.6,564,553,11,1743,1409,32,0,38,0
12577,620,150321,147680,477,1613,710,903,28,1.7,620,620,0,1613,1204,58,0,0,188
12578,949,97367,145967,638,2302,1253,1049,161,7,1044,949,95,2306,2012,40,0,11,68
12580,1624,116207,179327,1094,3876,2063,1813,264,6.8,1695,1624,71,4169,3579,198,0,72,14
12581,897,93274,130972,614,1923,918,1005,253,13.2,1144,897,247,1928,1567,1,0,49,210
12582,1704,131867,162317,1373,4510,2070,2440,86,1.9,1735,1704,31,6157,4023,1093,14,71,374
12583,805,69063,92393,457,1927,824,1103,387,20.1,1027,805,222,1927,1751,1,0,31,53
12585,478,112885,145090,298,1252,613,639,149,11.9,478,478,0,1252,1039,7,8,64,0
12586,4367,94107,109640,3058,12622,6236,6386,1640,13,4711,4367,344,12874,8790,911,256,302,735
12589,5468,118214,134614,3977,18698,9678,9020,5077,27.2,5871,5468,403,19639,13249,1969,82,182,1631
12590,14224,98252,119494,9269,35610,18014,17596,2133,6,14563,14224,339,35823,25466,2989,237,1493,2804
12592,426,72188,134914,289,1274,764,510,169,13.3,508,426,82,1280,988,77,0,0,123
12594,1485,130206,117821,1003,3634,1603,2031,497,13.7,1605,1485,120,3645,2661,343,0,16,474
12601,17095,64769,103562,9152,41357,20776,20581,6320,15.3,17972,17095,877,44696,21169,11099,349,1266,3175
12603,16970,104185,127259,10827,40635,19734,20901,3234,8,17468,16970,498,41513,28504,4794,387,2410,1974
12604,59,-,N,0,158,46,112,158,100,59,59,0,2118,1435,143,5,240,140
12701,4859,56601,74923,2646,11763,5914,5849,2650,22.5,7188,4859,2329,12191,6347,1906,105,629,1383
12719,451,75487,114443,187,892,489,403,89,10,816,451,365,892,778,4,6,8,24
12720,101,-,171908,101,434,266,168,0,0,109,101,8,434,434,0,0,0,0
12721,2427,84188,100232,1705,7544,4038,3506,1152,15.3,2876,2427,449,7590,6073,258,1,100,106
12722,0,-,-,0,0,0,0,0,-,0,0,0,0,0,0,0,0,0
12723,779,94940,113606,486,1851,783,1068,172,9.3,1212,779,433,1854,1408,262,12,8,34
12724,36,-,143556,33,77,40,37,3,3.9,87,36,51,77,67,0,0,0,7
12725,72,88929,108290,62,318,179,139,149,46.9,247,72,175,318,230,0,0,19,11
12726,545,73919,92148,302,1169,667,502,104,8.9,773,545,228,1169,1109,13,0,3,25
12729,540,67917,98150,355,1241,633,608,128,10.3,688,540,148,1307,880,189,0,154,0
12732,465,50375,107893,285,810,391,419,47,5.8,702,465,237,810,686,0,0,3,13
12733,84,-,43633,79,676,309,367,574,84.9,1221,84,1137,1891,925,592,0,19,230
12734,300,37234,54616,44,423,148,275,76,18,601,300,301,563,418,4,13,9,96
12736,81,43958,73117,50,149,68,81,16,10.7,149,81,68,149,133,0,0,0,0
12737,672,102150,114852,438,1758,1015,743,231,13.1,1089,672,417,1817,1525,0,0,12,59
12738,119,72479,153222,113,444,226,218,11,2.5,167,119,48,444,303,0,0,0,65
12740,784,91630,126561,414,1683,898,785,108,6.4,1095,784,311,1683,1371,92,0,6,130
12741,140,65463,71868,75,309,135,174,22,7.1,308,140,168,309,218,12,0,0,0
12742,56,144167,200098,15,132,92,40,19,14.4,103,56,47,132,85,7,0,0,15
12743,155,-,441092,107,319,178,141,5,1.6,285,155,130,319,287,5,0,0,0
12745,6,-,N,0,6,0,6,0,0,26,6,20,6,6,0,0,0,0
12746,240,77566,98995,156,598,356,242,98,16.4,279,240,39,598,527,0,0,48,0
12747,803,61875,115866,503,2009,815,1194,352,17.5,1036,803,233,2036,1557,163,13,34,51
12748,726,75500,105322,403,1614,868,746,203,12.6,1022,726,296,1616,1405,63,0,2,18
12749,117,170524,137374,82,505,240,265,62,12.3,384,117,267,507,507,0,0,0,0
12750,26,-,63935,8,33,18,15,0,0,62,26,36,33,31,0,0,2,0
12751,463,54030,64370,274,1340,645,695,519,38.7,654,463,191,1340,1019,142,0,0,0
12752,170,55909,87172,59,301,148,153,28,9.3,260,170,90,301,252,37,0,0,8
12754,2840,56597,81767,1718,8304,4225,4079,980,11.8,3783,2840,943,8525,5514,626,118,139,1464
12758,1978,50577,109405,960,4014,2119,1895,518,12.9,3114,1978,1136,4061,3588,24,0,120,0
12759,448,60656,75347,346,1636,641,995,548,33.5,1085,448,637,1835,833,629,43,22,164
12760,148,91625,109913,93,337,196,141,4,1.2,364,148,216,337,322,0,0,12,0
12762,138,112545,88286,123,453,308,145,107,23.6,306,138,168,453,347,8,0,4,0
12763,391,-,65380,183,598,376,222,49,8.2,615,391,224,615,490,34,0,2,26
12764,849,62750,102590,484,1827,931,896,149,8.2,1477,849,628,1827,1444,263,0,8,52
12765,329,-,95595,207,653,394,259,50,7.7,364,329,35,653,653,0,0,0,0
12766,226,-,154567,144,524,245,279,46,8.8,392,226,166,524,495,0,0,18,0
12767,51,-,159190,32,180,102,78,0,0,74,51,23,180,180,0,0,0,0
12768,313,34406,77592,157,805,466,339,279,34.7,784,313,471,805,516,7,0,0,146
12769,177,-,90150,140,382,200,182,52,13.6,191,177,14,382,241,54,0,25,0
12770,101,106202,151578,68,241,109,132,0,0,137,101,36,241,238,0,0,0,0
12771,5628,67926,80562,3310,14185,6931,7254,2171,15.3,6163,5628,535,14345,10185,888,388,494,763
12775,980,108125,200509,668,2654,1430,1224,113,4.3,1506,980,526,2661,1860,156,3,115,285
12776,757,79875,107966,545,1973,1041,932,181,9.2,1882,757,1125,2046,1851,14,0,7,54
12777,321,143750,198219,231,782,398,384,26,3.3,498,321,177,791,707,2,0,26,15
12778,217,66406,89381,148,456,212,244,169,37.1,878,217,661,456,445,0,0,0,11
12779,793,48914,75556,483,2207,1106,1101,652,29.5,1562,793,769,2207,795,347,98,0,674
12780,1043,72219,104021,682,2245,1317,928,134,6,1162,1043,119,2245,1844,145,0,23,14
12781,60,-,66183,60,138,72,66,0,0,92,60,32,138,138,0,0,0,0
12783,640,60781,84786,289,1348,576,772,200,14.8,1473,640,833,1357,1125,77,3,0,70
12784,0,-,-,0,0,0,0,0,-,16,0,16,0,0,0,0,0,0
12785,318,122167,109967,283,968,384,584,5,0.5,379,318,61,968,486,113,6,25,16
12786,261,80568,103151,149,553,246,307,50,9,926,261,665,553,432,19,0,0,72
12787,79,57958,58710,45,131,54,77,14,10.7,79,79,0,131,117,0,0,0,0
12788,916,86176,113871,546,2445,1394,1051,329,13.5,1341,916,425,3122,1821,643,13,23,236
12789,1020,69636,89605,554,2636,1114,1522,228,8.6,1985,1020,965,2654,1585,221,0,130,45
12790,1855,82772,101142,1107,4341,2421,1920,353,8.1,2827,1855,972,4341,3451,271,8,173,30
12791,213,85181,80194,74,589,294,295,21,3.6,330,213,117,589,533,0,0,0,19
12792,101,-,144865,43,171,123,48,32,18.7,286,101,185,171,171,0,0,0,0
12801,6819,70019,84325,3641,14421,7281,7140,1667,11.6,7287,6819,468,14689,13341,420,5,72,28
12803,3637,80913,100321,2308,8863,4478,4385,1085,12.2,3819,3637,182,8915,8251,143,55,31,77
12804,12458,90074,116432,7888,27881,13556,14325,1944,7,13287,12458,829,28175,26299,238,8,153,310
12808,147,120250,130686,98,283,125,158,12,4.2,492,147,345,283,258,0,0,4,12
12809,1463,74631,84216,952,3522,1726,1796,315,8.9,1815,1463,352,3639,3465,12,0,12,37
12810,214,51500,70648,138,484,236,248,99,20.5,305,214,91,488,453,0,1,0,1
12811,65,-,73177,65,177,107,70,12,6.8,98,65,33,177,176,0,0,0,0
12812,89,170156,124404,32,265,158,107,12,4.5,262,89,173,265,253,0,0,0,0
12814,659,114861,116924,333,1145,673,472,82,7.2,1804,659,1145,1145,1129,16,0,0,0
12815,534,70917,85548,234,976,539,437,67,6.9,1208,534,674,999,991,0,0,0,4
12816,2085,79669,97020,1324,4683,2208,2475,418,8.9,2581,2085,496,4692,4348,77,2,61,12
12817,964,90469,102203,695,2022,1014,1008,144,7.1,2115,964,1151,2023,1911,0,0,64,13
12819,122,62059,80515,92,292,148,144,16,5.5,208,122,86,292,287,0,0,0,0
12820,7,-,N,7,14,7,7,0,0,45,7,38,14,14,0,0,0,0
12821,132,32344,45689,122,361,181,180,84,23.3,132,132,0,2228,959,986,0,15,129
12822,2426,80000,94255,1631,6141,3259,2882,773,12.6,3246,2426,820,6149,5881,5,7,5,38
12823,225,114450,98541,167,682,284,398,0,0,245,225,20,682,666,0,0,12,0
12824,460,123026,155585,322,1022,512,510,20,2,967,460,507,1022,984,13,0,0,0
12827,1556,81607,91325,955,3928,2096,1832,231,5.9,1862,1556,306,3935,3492,9,6,0,51
12828,3745,77776,95778,2577,9572,4766,4806,881,9.2,3974,3745,229,9775,9237,53,76,11,106
12831,7050,100833,122772,4740,17793,8596,9197,870,4.9,7228,7050,178,17834,16807,89,7,229,187
12832,2615,66415,81835,1735,6281,3147,3134,709,11.3,3136,2615,521,6395,5736,152,4,125,6
12833,2184,97621,170045,1429,5368,2680,2688,641,11.9,2327,2184,143,5368,4999,43,7,74,64
12834,2766,82931,100727,1740,6104,3002,3102,298,4.9,2996,2766,230,6137,5824,11,1,68,109
12835,1268,70638,106915,810,2700,1377,1323,246,9.1,2773,1268,1505,2700,2547,7,3,0,20
12836,264,81875,102528,125,473,249,224,51,10.8,729,264,465,473,462,0,0,0,0
12837,341,76979,89210,247,936,481,455,123,13.1,389,341,48,943,886,0,0,0,1
12838,297,65387,79753,193,699,395,304,73,10.4,322,297,25,699,661,0,0,0,0
12839,5779,70006,77139,3166,13273,6827,6446,1901,14.3,6515,5779,736,13618,12300,54,7,35,737
12841,66,61389,80773,21,87,26,61,8,9.2,362,66,296,87,87,0,0,0,0
12842,451,60592,82910,275,952,494,458,50,5.3,1320,451,869,952,856,1,0,1,26
12843,280,65227,83435,207,729,400,329,62,8.5,450,280,170,729,714,10,0,0,0
12844,95,181696,222728,74,195,104,91,10,5.1,414,95,319,207,195,7,0,0,3
12845,1959,95583,106238,1287,4279,2023,2256,293,6.8,3441,1959,1482,4389,4175,55,0,24,16
12846,1579,47449,78052,721,3007,1635,1372,627,20.9,2338,1579,759,3007,2962,17,3,0,0
12847,280,72700,126870,177,667,330,337,78,11.7,1130,280,850,667,620,11,0,11,9
12849,118,112250,133028,111,398,163,235,71,17.8,118,118,0,398,396,0,0,0,2
12850,978,94189,112821,769,2514,1363,1151,188,7.5,1248,978,270,2537,2461,37,0,0,0
12851,133,77969,94862,92,303,161,142,30,9.9,246,133,113,304,280,2,7,0,3
12852,164,76000,96435,103,351,188,163,17,4.8,663,164,499,381,337,5,1,10,3
12853,585,58850,86140,332,1308,515,793,108,8.3,1070,585,485,1384,1304,11,0,38,0
12854,40,-,N,18,98,13,85,0,0,40,40,0,98,98,0,0,0,0
12855,98,67955,88059,74,197,98,99,15,7.6,241,98,143,198,194,0,0,0,0
12856,170,58714,73689,91,300,94,206,0,0,336,170,166,300,300,0,0,0,0
12857,319,63935,74220,194,599,290,309,68,11.4,635,319,316,613,589,0,1,3,0
12858,87,151875,141247,45,167,83,84,0,0,329,87,242,167,163,0,0,0,0
12859,657,72847,99841,484,1629,818,811,242,14.9,739,657,82,1629,1535,28,0,0,15
12860,147,-,107840,93,377,221,156,68,18,268,147,121,377,311,3,10,0,0
12861,210,98125,113267,173,511,268,243,51,10,538,210,328,516,501,0,0,3,2
12862,95,-,110958,23,149,44,105,0,0,95,95,0,149,123,0,0,0,0
12863,309,92536,93386,196,803,426,377,43,5.4,363,309,54,870,870,0,0,0,0
12864,4,-,N,0,9,5,4,0,0,103,4,99,9,9,0,0,0,0
12865,1359,70868,87723,821,3349,1676,1673,481,14.4,1654,1359,295,3353,3033,122,19,0,44
12866,18056,98374,132055,10076,37120,18068,19052,3189,8.6,20462,18056,2406,39657,35058,921,54,990,522
12870,780,65326,83912,478,1761,874,887,174,9.9,1852,780,1072,1770,1725,0,0,0,15
12871,1677,83775,99542,1014,3965,2186,1779,237,6,1844,1677,167,3997,3698,30,0,6,129
12872,0,-,-,0,0,0,0,0,-,83,0,83,0,0,0,0,0,0
12873,343,95417,112864,175,814,352,462,125,15.4,452,343,109,820,761,6,0,0,0
12874,84,-,105864,50,154,70,84,23,14.9,370,84,286,154,150,0,0,0,0
12878,284,61667,71399,177,768,341,427,60,7.8,502,284,218,768,691,28,1,6,0
12883,2082,67532,83827,1261,4650,2472,2178,703,15.1,2845,2082,763,4781,4631,0,2,0,13
12884,222,46071,72163,165,559,272,287,98,17.5,248,222,26,567,522,3,0,0,0
12885,2165,65454,77498,1127,4481,2296,2185,562,12.5,2724,2165,559,4531,4154,0,0,148,0
12886,87,122719,110231,80,186,105,81,12,6.5,117,87,30,199,161,13,0,0,0
12887,1754,55361,68399,1089,4629,2168,2461,931,20.1,2163,1754,409,4629,4091,21,3,6,76
12901,14282,59413,79987,7440,28971,14221,14750,5344,18.4,15426,14282,1144,32012,28030,1019,181,913,338
12903,874,76912,104005,425,1650,716,934,121,7.3,931,874,57,1740,1658,9,10,29,9
12910,670,52092,68656,480,1683,952,731,229,13.6,824,670,154,1994,1745,116,4,31,70
12911,33,-,N,21,44,23,21,12,27.3,33,33,0,44,44,0,0,0,0
12912,758,70469,96286,488,1860,947,913,107,5.8,1011,758,253,1860,1791,0,1,4,3
12913,473,71083,80112,266,1102,550,552,177,16.1,651,473,178,1128,1095,3,0,0,18
12914,358,43750,62056,281,892,474,418,214,24,439,358,81,892,825,0,26,0,0
12915,36,-,65433,28,61,37,24,0,0,36,36,0,61,60,0,0,0,0
12916,916,59762,74852,651,2247,1188,1059,463,20.6,1060,916,144,2250,2098,0,36,1,13
12917,450,70400,77822,330,1186,512,674,169,14.2,553,450,103,1194,1090,5,41,0,0
12918,1191,93902,132494,986,2752,1446,1306,35,1.3,1243,1191,52,2762,2588,0,0,10,105
12919,1099,77072,126997,788,2789,1333,1456,339,12.2,1262,1099,163,2789,2553,62,0,0,60
12920,1032,70714,93528,755,2452,1223,1229,437,17.8,1530,1032,498,2509,2247,97,22,11,8
12921,990,100500,117693,810,2642,1352,1290,329,12.5,1313,990,323,2771,2458,47,0,22,0
12922,17,95625,94441,14,33,18,15,0,0,91,17,74,33,31,0,1,0,0
12923,228,50000,56982,136,463,241,222,71,15.3,286,228,58,463,447,0,0,0,0
12924,111,-,43498,43,210,70,140,7,3.3,111,111,0,230,223,0,0,0,0
12926,1074,55481,70094,732,2464,1213,1251,407,16.5,1176,1074,102,2493,2406,0,40,0,4
12927,169,64583,78973,113,308,150,158,16,5.2,521,169,352,308,305,0,0,0,0
12928,771,79890,94066,574,1805,889,916,80,4.4,1110,771,339,1805,1719,0,5,0,14
12929,341,68472,81370,203,840,396,444,76,9,412,341,71,2882,1539,1018,23,11,225
12930,337,67458,82378,247,866,386,480,113,13,412,337,75,866,782,0,12,3,3
12932,599,61801,87369,290,1086,521,565,123,11.3,872,599,273,1183,1079,46,0,0,12
12933,3,-,N,3,7,3,4,0,0,3,3,0,7,7,0,0,0,0
12934,462,76167,83220,299,1147,608,539,132,11.5,535,462,73,1147,1060,67,0,0,0
12935,541,55625,75773,342,1148,562,586,179,15.6,903,541,362,1159,1114,3,0,0,0
12936,315,73843,87724,201,693,359,334,88,12.7,646,315,331,693,662,0,0,0,4
12937,546,49265,63873,366,1340,652,688,277,20.7,664,546,118,1340,1221,0,51,2,30
12939,97,51736,87770,48,162,105,57,16,9.9,97,97,0,162,160,0,0,0,0
12941,626,77833,88995,381,1447,858,589,124,8.6,1062,626,436,1477,1400,21,3,3,34
12942,259,113750,122413,140,459,225,234,18,3.9,605,259,346,462,446,0,4,8,0
12943,121,54943,90603,63,276,102,174,27,9.8,419,121,298,293,265,0,1,9,0
12944,1591,70375,89797,938,4025,1882,2143,649,16.1,2008,1591,417,4043,3903,16,0,7,24
12945,197,88114,85887,169,535,271,264,33,6.2,539,197,342,535,535,0,0,0,0
12946,2346,78261,118631,1245,4619,2296,2323,536,11.6,3923,2346,1577,4805,4497,56,0,30,58
12950,339,74375,75622,236,662,279,383,9,1.4,417,339,78,701,635,32,5,0,0
12952,107,-,39403,44,226,107,119,52,23,266,107,159,226,180,0,0,0,0
12953,4796,64673,82186,2983,10216,4942,5274,1265,12.4,5693,4796,897,12842,10656,1254,42,20,745
12955,218,73214,72430,130,494,246,248,72,14.6,389,218,171,494,485,5,0,0,0
12956,583,67526,72370,433,1447,603,844,255,17.6,613,583,30,1538,1398,29,12,9,12
12957,788,57839,60843,389,1721,912,809,392,22.8,868,788,80,1721,1710,0,2,0,0
12958,746,58512,70167,529,1650,814,836,180,10.9,944,746,198,1650,1650,0,0,0,0
12959,879,68813,85960,396,1790,928,862,387,21.6,927,879,48,1790,1778,0,0,0,0
12960,450,61443,79928,343,995,476,519,8,0.8,477,450,27,995,990,3,0,0,2
12961,78,-,N,13,92,14,78,0,0,119,78,41,92,27,0,0,0,65
12962,2293,67511,80424,1368,5131,2432,2699,531,10.3,2412,2293,119,5131,5007,13,0,39,0
12964,27,79063,119233,15,46,31,15,12,26.1,98,27,71,46,44,0,0,0,2
12965,142,63214,72501,54,281,169,112,43,15.3,177,142,35,281,263,0,0,12,3
12966,1188,66016,78497,813,2882,1479,1403,546,18.9,1433,1188,245,2962,2812,0,18,20,52
12967,461,78438,82229,298,1360,729,631,139,10.2,461,461,0,1363,1314,1,0,0,0
12969,129,59063,68782,95,253,130,123,37,14.6,397,129,268,253,248,0,2,0,0
12970,180,81250,109122,122,428,200,228,17,4,390,180,210,1022,833,28,11,57,0
12972,2804,120822,119121,1853,7044,3579,3465,413,5.9,2965,2804,161,7063,6401,75,0,25,158
12973,55,86875,84544,44,136,81,55,12,8.8,97,55,42,136,130,0,0,6,0
12974,837,43832,58517,426,1545,720,825,438,28.3,914,837,77,1545,1430,6,2,14,7
12975,84,-,80986,18,107,37,70,0,0,119,84,35,107,86,4,0,7,1
12976,119,70417,93421,52,196,86,110,10,5.1,264,119,145,196,187,0,0,0,9
12977,8,-,N,8,16,0,16,0,0,32,8,24,1186,459,629,13,2,45
12978,81,97470,106596,81,243,111,132,0,0,81,81,0,243,243,0,0,0,0
12979,1256,47135,65202,621,2542,1318,1224,399,15.7,1344,1256,88,2542,2387,3,2,36,64
12980,528,61447,72346,315,1061,563,498,154,14.5,1151,528,623,1064,1006,0,2,0,0
12981,838,73258,79908,611,2233,1185,1048,460,20.6,1061,838,223,2233,2191,0,19,0,0
12983,3520,64604,89871,1732,7225,3864,3361,1037,14.4,4664,3520,1144,7410,6983,151,45,31,1
12985,326,74432,86741,252,775,416,359,154,19.9,378,326,52,775,743,0,0,0,0
12986,2313,60717,77899,1299,5172,2545,2627,876,16.9,3617,2313,1304,5304,5049,82,12,3,29
12987,95,111083,106212,60,188,84,104,45,23.9,144,95,49,188,176,0,0,0,0
12989,482,78438,87559,312,998,526,472,201,20.1,879,482,397,1012,940,0,0,9,38
12992,1706,78214,114816,1097,4078,2028,2050,260,6.4,1837,1706,131,4129,4022,31,0,21,0
12993,776,64688,99645,412,1725,1003,722,224,13,1227,776,451,1730,1658,11,0,2,5
12996,875,64306,96667,586,1922,885,1037,246,12.8,1553,875,678,1937,1806,8,1,0,88
12997,527,80568,114618,399,1280,636,644,42,3.3,818,527,291,1280,1248,2,9,0,3
12998,141,41411,51914,98,334,148,186,42,12.6,233,141,92,334,252,0,13,0,0
13020,41,90074,81078,36,117,51,66,4,3.4,41,41,0,117,113,0,0,0,0
13021,16973,58946,80913,9560,36499,17497,19002,5549,15.2,18847,16973,1874,37479,32952,1107,44,275,585
13024,0,-,-,0,0,0,0,0,-,0,0,0,1209,358,716,15,0,107
13026,534,96000,102202,362,1285,702,583,48,3.7,755,534,221,1703,1526,14,10,8,80
13027,14779,91369,114617,9533,35006,17130,17876,2600,7.4,15276,14779,497,35233,31454,726,179,503,198
13028,334,88906,81131,227,904,498,406,98,10.8,616,334,282,913,848,0,0,0,0
13029,2961,101555,120179,2185,7502,3758,3744,1005,13.4,3304,2961,343,7594,6875,117,57,60,0
13030,1440,77541,99779,1004,3529,1733,1796,228,6.5,1797,1440,357,3611,3277,38,0,79,51
13031,7108,92687,114321,4349,15972,8135,7837,904,5.7,7414,7108,306,16076,14646,113,8,250,134
13032,5229,74217,86464,3422,12928,6587,6341,984,7.6,6217,5229,988,12964,11529,225,114,45,44
13033,1320,80234,99883,988,3635,1843,1792,369,10.2,1475,1320,155,3660,3448,0,2,11,82
13034,809,102813,143683,565,2088,1152,936,147,7,1119,809,310,2088,1905,29,0,12,35
13035,3033,110972,146716,2115,7147,3366,3781,374,5.2,3345,3033,312,8191,7668,102,4,100,19
13036,3618,87610,110888,2349,8865,4429,4436,959,10.8,3959,3618,341,9079,8814,10,5,2,12
13037,3701,79191,106615,2624,9444,5019,4425,885,9.4,3987,3701,286,9519,8890,41,52,3,55
13039,6825,108694,124346,5025,17049,8253,8796,1087,6.4,7241,6825,416,17184,15931,267,7,488,109
13040,1035,67049,77848,690,2662,1340,1322,314,11.8,1274,1035,239,2683,2569,0,11,0,31
13041,4560,108491,120579,3350,11919,5861,6058,341,2.9,4686,4560,126,12094,10197,358,0,342,0
13042,773,102031,111039,529,1884,1032,852,124,6.6,948,773,175,1884,1825,0,0,2,0
13044,1138,69300,91934,754,2839,1696,1143,328,11.6,1216,1138,78,2884,2625,0,1,0,0
13045,11238,67028,80792,6348,24988,12507,12481,3869,15.5,12420,11238,1182,28388,25082,859,25,501,454
13051,35,-,N,6,52,46,6,0,0,35,35,0,52,40,0,0,0,0
13052,646,78750,89544,467,1762,816,946,190,10.8,1054,646,408,1762,1729,0,0,0,3
13053,1967,71950,92186,1279,4239,2000,2239,899,21.2,2099,1967,132,4756,4131,93,0,187,103
13054,476,99643,100786,414,1289,626,663,79,6.1,542,476,66,1289,1261,0,2,0,0
13057,6504,77908,95734,3781,14266,7191,7075,1134,7.9,6744,6504,240,14476,12884,329,41,322,124
13060,1250,60661,81982,843,2845,1334,1511,393,13.8,1329,1250,79,2845,2566,11,0,12,23
13061,319,83239,107083,191,637,314,323,45,7.1,634,319,315,641,598,21,0,0,20
13062,122,-,157810,102,241,112,129,45,18.7,122,122,0,241,241,0,0,0,0
13063,796,80250,97410,430,1642,775,867,79,4.8,810,796,14,1644,1587,0,0,16,18
13065,74,-,75819,23,131,51,80,44,33.6,74,74,0,131,131,0,0,0,0
13066,5455,121599,161897,3573,12679,5755,6924,736,5.8,5971,5455,516,12680,11377,279,4,410,73
13068,1973,79521,94283,1176,4364,2134,2230,358,8.2,2165,1973,192,4464,4273,27,8,18,3
13069,9819,63156,80807,6131,22874,11577,11297,4497,19.7,10593,9819,774,23176,21876,159,14,26,309
13071,289,79464,99687,217,753,390,363,58,7.7,305,289,16,760,734,0,0,0,0
13072,335,46836,60604,223,784,390,394,125,15.9,474,335,139,811,771,20,6,0,6
13073,2651,71316,85748,1754,6153,2970,3183,535,8.7,2803,2651,152,6246,5499,101,0,28,64
13074,1739,73681,86850,1228,4413,2265,2148,659,14.9,1930,1739,191,4471,4115,4,72,35,65
13076,987,87865,167040,734,2521,1323,1198,411,16.3,1028,987,41,2521,2382,0,3,34,14
13077,2981,70111,90015,1921,6558,3284,3274,369,5.6,3245,2981,264,6567,6217,0,1,137,13
13078,3849,114657,159500,2895,10067,4953,5114,391,3.9,3949,3849,100,10564,8025,503,14,1157,92
13080,1354,77039,104386,1008,3272,1517,1755,342,10.5,1681,1354,327,3282,3009,20,15,8,56
13081,491,89583,112324,333,1094,548,546,71,6.5,732,491,241,1094,969,5,0,26,0
13082,1627,89485,97662,1167,4177,2057,2120,267,6.4,1808,1627,181,4177,3946,28,0,12,6
13083,772,60625,77009,431,1854,922,932,487,26.3,931,772,159,1861,1737,22,0,37,14
13084,1571,87917,113030,1073,3764,1768,1996,146,3.9,1627,1571,56,3764,3231,105,41,0,2
13087,94,130455,150036,70,252,141,111,21,8.3,167,94,73,252,230,0,0,0,0
13088,10799,73814,83675,4995,21745,10598,11147,1922,8.8,11242,10799,443,21875,18599,701,96,952,454
13090,12219,90315,102476,7058,28923,14117,14806,3129,10.8,12591,12219,372,29180,23395,1827,47,772,395
13092,1015,64453,86346,698,2692,1465,1227,624,23.2,1116,1015,101,2707,2266,37,16,57,9
13101,949,62670,70723,591,2163,1191,972,205,9.5,987,949,38,2221,2103,0,0,0,36
13102,33,-,N,16,67,34,33,0,0,41,33,8,67,67,0,0,0,0
13103,122,65139,53966,83,239,151,88,37,15.5,122,122,0,239,173,0,0,0,0
13104,6473,123770,165861,4671,16448,7916,8532,943,5.7,6575,6473,102,16504,14039,401,42,1176,151
13108,2726,90377,110320,1727,6144,3074,3070,333,5.4,2799,2726,73,6144,6020,1,0,9,12
13110,906,100000,123741,718,2362,1127,1235,78,3.3,1297,906,391,2374,2141,0,0,0,60
13111,621,59886,64635,408,1660,864,796,248,14.9,720,621,99,1660,1321,0,0,12,0
13112,684,74828,105696,521,1827,808,1019,207,11.3,800,684,116,1827,1766,0,0,0,0
13113,20,39375,60780,14,41,17,24,6,14.6,22,20,2,41,38,0,1,0,0
13114,2935,73328,87016,1929,7262,3670,3592,1090,15,3351,2935,416,7313,7036,16,0,10,132
13115,81,71172,84800,56,223,113,110,51,22.9,89,81,8,223,203,6,0,0,3
13116,1408,93125,106326,957,3554,2044,1510,170,4.8,1467,1408,59,3657,3275,12,0,44,189
13117,78,42750,47101,55,211,81,130,10,4.7,91,78,13,211,199,2,0,0,0
13118,2034,67614,86669,1322,4814,2308,2506,531,11,2702,2034,668,5514,4826,323,5,13,151
13119,0,-,-,0,0,0,0,0,-,0,0,0,0,0,0,0,0,0
13120,772,54167,83474,512,1878,857,1021,211,11.2,800,772,28,1881,1290,69,402,56,0
13121,0,-,-,0,0,0,0,0,-,0,0,0,0,0,0,0,0,0
13122,598,77984,93382,343,1289,557,732,47,3.6,671,598,73,1289,1213,0,0,0,0
13123,35,-,N,0,35,0,35,0,0,35,35,0,35,35,0,0,0,0
13124,43,95625,104656,34,95,46,49,3,3.2,73,43,30,95,92,0,0,0,0
13126,13616,63590,82511,8024,31629,15621,16008,5385,17,15668,13616,2052,36199,32267,978,31,697,483
13131,1203,66992,90816,776,2831,1300,1531,357,12.6,1306,1203,103,2856,2638,19,2,11,40
13132,1657,71780,93571,996,3561,1870,1691,535,15,1813,1657,156,3561,3308,19,0,0,10
13134,27,-,116019,15,129,109,20,8,6.2,37,27,10,129,39,0,0,0,0
13135,2387,82977,101655,1654,6158,2891,3267,771,12.5,2592,2387,205,6229,5742,21,10,107,0
13136,160,41944,66167,84,377,175,202,96,25.5,210,160,50,377,373,0,0,0,0
13138,75,86382,74863,75,209,162,47,4,1.9,75,75,0,209,205,2,0,2,0
13140,1652,60135,83412,1091,4175,2109,2066,694,16.6,1895,1652,243,4192,3990,17,0,0,13
13141,247,83125,96642,170,638,359,279,15,2.4,296,247,49,643,582,0,0,6,0
13142,2626,85000,101325,1758,6495,3189,3306,922,14.2,3465,2626,839,6568,6129,8,2,0,152
13143,889,72371,91095,605,2354,1149,1205,332,14.1,1034,889,145,2405,2228,2,0,0,3
13144,441,62578,77103,291,1096,551,545,258,23.5,782,441,341,1105,1018,25,0,1,0
13145,810,50238,64239,501,1794,1010,784,412,23,1063,810,253,1794,1767,0,3,0,0
13146,743,61688,75824,485,2035,1039,996,154,7.6,828,743,85,2050,1943,2,0,13,7
13147,379,74861,86441,258,1043,539,504,136,13,476,379,97,1043,951,34,0,0,54
13148,4966,58971,83016,2609,10630,5195,5435,1655,15.6,5565,4966,599,10798,9901,231,0,183,138
13152,3276,102727,165449,2074,7458,3833,3625,501,6.7,4044,3276,768,7548,7294,25,17,43,111
13153,161,147901,126028,132,510,246,264,0,0,161,161,0,510,510,0,0,0,0
13154,13,-,N,13,38,13,25,0,0,13,13,0,38,38,0,0,0,0
13155,269,66146,82566,179,654,335,319,86,13.1,345,269,76,654,631,0,0,0,0
13156,984,70662,80729,634,2104,1126,978,152,7.2,1629,984,645,2108,1953,0,1,0,111
13157,328,53125,77270,158,547,295,252,47,8.6,671,328,343,547,508,0,2,7,7
13158,539,80809,94466,339,1377,758,619,109,7.9,650,539,111,1377,1206,113,0,0,9
13159,2055,94809,119141,1451,5285,2639,2646,431,8.2,2273,2055,218,5297,4858,21,8,20,94
13160,839,88750,106734,524,2254,1112,1142,203,9,1000,839,161,2321,2109,34,0,55,19
13162,115,-,43430,33,150,38,112,41,27.3,287,115,172,150,150,0,0,0,0
13163,118,77500,83322,85,275,124,151,25,9.1,120,118,2,334,297,11,0,0,17
13164,916,81212,112147,685,2687,1339,1348,201,7.5,978,916,62,2695,2465,19,29,0,0
13165,4153,63915,79093,2245,9219,4520,4699,994,10.8,4501,4153,348,9429,8473,143,0,5,88
13166,2432,76484,88553,1524,5654,3184,2470,938,16.6,2629,2432,197,5667,5277,29,4,3,1
13167,1268,74700,86668,822,2976,1509,1467,439,14.8,1339,1268,71,2984,2876,0,0,0,4
13202,3249,27365,62019,1217,6189,3220,2969,3257,52.6,3525,3249,276,6842,2382,2923,112,381,309
13203,7974,46526,68308,3229,16633,8287,8346,4876,29.3,9092,7974,1118,17387,9543,4602,126,1269,202
13204,8817,42585,59581,4057,19478,9107,10371,7030,36.1,10410,8817,1593,19511,9816,5597,236,126,1265
13205,7330,39171,57697,3892,17326,8010,9316,4661,26.9,8868,7330,1538,18562,7069,8285,155,556,686
13206,7815,60314,71828,3720,16653,8529,8124,2437,14.6,8460,7815,645,16848,12042,2238,34,784,232
13207,5269,59495,76690,3242,12374,5888,6486,3181,25.7,5954,5269,685,12383,5678,4530,184,179,324
13208,9188,40641,58337,4931,22529,11080,11449,7638,33.9,10325,9188,1137,22549,10841,5461,198,3079,740
13209,5877,67307,82627,3469,12995,6021,6974,1107,8.5,6374,5877,497,12995,11492,473,37,126,81
13210,8117,38783,56581,2579,16097,7581,8516,5165,32.1,9774,8117,1657,19298,11464,3867,146,1864,468
13211,2512,67672,76595,1461,6155,2783,3372,673,10.9,2624,2512,112,6155,4887,249,30,334,254
13212,8770,74931,91451,5331,20091,9738,10353,2217,11,9213,8770,443,20185,18173,294,4,170,469
13214,3054,93200,122129,1717,7149,3336,3813,545,7.6,3417,3054,363,8713,5972,1273,95,409,205
13215,5576,112328,145351,3680,13565,6861,6704,367,2.7,5925,5576,349,14599,12386,1041,25,161,249
13219,6268,81414,103466,4153,15287,7301,7986,971,6.4,6551,6268,283,15546,13820,578,33,210,142
13224,3630,81667,106805,2186,8512,4132,4380,1222,14.4,3948,3630,318,8638,4194,2892,27,486,155
13244,5,-,N,0,11,6,5,5,45.5,24,5,19,8816,5770,682,87,1813,247
13290,0,-,-,0,0,0,0,0,-,0,0,0,0,0,0,0,0,0
13301,48,124559,114890,38,113,74,39,10,8.8,111,48,63,113,113,0,0,0,0
13302,609,55156,69691,375,1403,709,694,268,19.1,986,609,377,1403,1336,0,1,4,15
13303,595,86012,98349,418,1452,706,746,224,15.4,642,595,47,1455,1431,2,7,0,0
13304,710,105313,134262,503,1841,914,927,167,9.1,796,710,86,1841,1767,11,0,9,0
13305,167,-,97104,92,414,253,161,50,12.1,182,167,15,421,408,4,0,0,0
13308,1701,86072,97070,1292,4217,1928,2289,369,8.8,2026,1701,325,4239,3956,0,0,53,26
13309,2540,70377,82536,1479,5716,2861,2855,648,11.3,2804,2540,264,5828,5524,36,1,16,13
13310,278,98182,83441,150,731,426,305,47,6.4,389,278,111,731,731,0,0,0,0
13312,157,71172,71144,89,288,153,135,39,13.5,638,157,481,288,288,0,0,0,0
13313,249,36328,63631,185,562,305,257,152,27,284,249,35,562,538,3,0,0,11
13314,34,38750,56771,31,145,60,85,88,60.7,62,34,28,145,145,0,0,0,0
13315,485,65417,91372,304,1235,600,635,187,15.1,651,485,166,1239,1213,3,0,0,0
13316,2774,62941,74101,1498,5815,2795,3020,491,8.4,3175,2774,401,5924,5548,59,4,26,44
13317,1249,69250,84094,864,3942,1966,1976,369,9.4,1548,1249,299,3970,3800,21,4,19,16
13318,397,78125,86387,288,970,500,470,125,12.9,424,397,27,982,909,62,0,0,0
13319,253,72726,76207,159,434,259,175,0,0,306,253,53,434,390,0,0,0,0
13320,717,80956,95974,513,2025,1022,1003,334,16.5,1039,717,322,2027,1978,0,1,6,4
13321,511,58508,75214,159,797,330,467,28,3.5,600,511,89,815,751,8,0,0,56
13322,397,92250,106909,315,1059,575,484,45,4.2,573,397,176,1059,1029,0,0,0,0
13323,4377,82060,103353,2618,8893,4253,4640,671,7.5,4664,4377,287,11014,10141,101,44,229,148
13324,793,80313,108107,532,1692,932,760,168,9.9,1372,793,579,1714,1626,11,27,0,9
13325,413,66458,78085,229,882,488,394,75,8.5,685,413,272,882,855,3,0,0,3
13326,1913,70977,116116,1089,4242,2161,2081,355,8.4,2724,1913,811,4536,3970,90,0,217,67
13327,778,61250,80234,502,1956,1075,881,190,9.7,1224,778,446,1956,1928,15,0,0,0
13328,564,95000,123996,370,1302,661,641,37,2.8,580,564,16,1302,1106,10,0,21,114
13329,1413,57014,71585,912,3326,1702,1624,399,12,1685,1413,272,3326,3081,16,0,17,69
13331,98,64500,73352,72,175,88,87,0,0,953,98,855,175,175,0,0,0,0
13332,869,74511,85171,642,2695,1463,1232,294,10.9,1172,869,303,2695,2496,72,0,8,0
13333,17,76250,66894,15,40,14,26,2,5,33,17,16,40,37,0,0,0,0
13334,410,50875,64132,245,887,502,385,141,15.9,783,410,373,887,842,23,0,0,4
13335,462,54048,67059,286,1366,733,633,384,28.1,613,462,151,1388,1293,15,0,0,9
13337,357,74821,115367,211,690,306,384,22,3.2,486,357,129,690,624,12,0,9,0
13338,608,58393,82718,307,1289,671,618,128,9.9,1495,608,887,1293,1272,4,8,0,0
13339,2208,57885,74186,1356,6102,3235,2867,727,11.9,2703,2208,495,6131,5838,93,7,0,26
13340,3265,69928,95234,2021,7306,3696,3610,477,6.5,3427,3265,162,7322,6699,181,0,34,103
13342,83,81023,79205,50,263,149,114,12,4.6,83,83,0,263,213,0,0,0,0
13343,693,68514,76218,474,1534,845,689,159,10.4,1179,693,486,1543,1503,3,1,2,5
13345,83,51250,68228,36,184,84,100,38,20.7,126,83,43,184,168,16,0,0,0
13346,1737,65391,102037,1022,3579,1913,1666,475,13.3,2261,1737,524,6275,5430,306,0,214,122
13348,616,77903,94081,396,1529,839,690,113,7.4,732,616,116,1529,1477,7,0,0,0
13350,4221,62548,77041,2375,9047,4380,4667,1453,16.1,4709,4221,488,9641,8714,154,0,148,117
13352,1,-,N,1,21,20,1,0,0,41,1,40,21,18,0,0,0,0
13353,31,79375,94484,17,54,25,29,2,3.7,278,31,247,54,52,0,1,0,0
13354,1241,92750,105536,892,3124,1557,1567,182,5.8,1259,1241,18,3124,3044,5,0,13,0
13355,318,70250,177953,214,883,471,412,28,3.2,391,318,73,883,841,0,0,13,0
13357,4488,62500,72824,2619,9888,4789,5099,1503,15.2,5101,4488,613,10073,9346,56,6,31,46
13360,73,117708,127251,40,193,118,75,14,7.3,819,73,746,193,193,0,0,0,0
13361,240,100000,99588,185,666,335,331,84,12.6,314,240,74,666,632,4,0,0,0
13363,927,88427,108180,689,2290,1124,1166,162,7.1,1017,927,90,2290,2169,17,0,0,18
13364,131,77739,82740,119,359,162,197,73,20.3,147,131,16,359,291,0,0,6,0
13365,3367,60458,81924,2081,8460,4420,4040,1632,19.3,4066,3367,699,8545,7928,77,0,4,133
13367,3624,70781,83956,2592,8621,4196,4425,951,11,4546,3624,922,8786,8049,160,6,21,133
13368,420,60000,65803,310,1025,471,554,122,11.9,561,420,141,1025,1004,3,0,0,0
13402,541,62204,68578,385,1290,565,725,259,20.1,712,541,171,1295,1246,3,0,0,3
13403,1952,100060,109118,1230,4786,2432,2354,353,7.4,2082,1952,130,7133,5859,806,29,92,223
13404,63,-,60062,32,162,81,81,0,0,63,63,0,162,156,0,0,0,0
13406,168,98000,89743,128,485,264,221,47,9.7,222,168,54,491,489,0,0,0,0
13407,2088,72700,85285,1383,5087,2601,2486,690,13.6,2283,2088,195,5125,4729,13,0,69,24
13408,786,64762,83649,474,1996,1041,955,121,6.1,984,786,198,3422,2834,171,3,226,96
13409,869,69103,78684,610,2117,1088,1029,225,10.6,966,869,97,2123,2052,0,13,0,0
13410,321,-,48774,146,575,233,342,148,25.7,361,321,40,575,499,0,0,3,0
13411,1169,58651,74067,779,2855,1496,1359,565,19.8,1484,1169,315,2920,2794,2,0,6,14
13413,7091,91899,131642,4531,16143,7219,8924,904,5.6,7537,7091,446,16940,14998,173,41,735,420
13415,45,85417,147298,27,92,55,37,23,25,45,45,0,92,89,0,0,0,0
13416,859,83125,86942,574,2120,1036,1084,256,12.1,973,859,114,2120,2032,12,0,0,1
13417,1653,56055,68154,720,3012,1470,1542,268,8.9,1869,1653,216,3012,2968,2,0,30,0
13418,67,113125,110060,51,186,123,63,7,3.8,92,67,25,186,186,0,0,0,0
13420,430,107770,107763,354,890,444,446,47,5.3,2441,430,2011,890,860,25,0,0,0
13421,5573,63732,89814,3094,12604,5976,6628,1437,11.4,5953,5573,380,12742,11776,95,42,56,272
13424,956,90179,120202,632,1992,1060,932,154,7.7,1023,956,67,2285,1890,92,1,180,11
13425,741,64628,100161,466,1743,953,790,186,10.7,803,741,62,1743,1683,3,0,10,11
13428,650,73250,87841,346,1413,660,753,214,15.1,742,650,92,1470,1420,4,0,1,12
13431,742,83200,94955,581,1923,1036,887,199,10.3,830,742,88,1929,1815,5,5,28,0
13433,691,49696,58866,424,1708,877,831,294,17.2,898,691,207,1708,1664,5,0,0,9
13435,122,46413,66632,69,300,136,164,0,0,150,122,28,337,259,61,0,0,0
13436,48,74167,74154,22,85,38,47,14,16.5,487,48,439,107,94,13,0,0,0
13437,131,48375,59798,68,254,153,101,38,15,645,131,514,254,244,0,0,0,0
13438,1412,68140,90374,971,3298,1585,1713,378,11.5,1944,1412,532,3310,3195,28,0,14,6
13439,1403,63681,89797,915,3667,1800,1867,496,13.5,2192,1403,789,3667,3535,16,0,27,10
13440,17645,65497,83024,10372,39396,19912,19484,5896,15,19286,17645,1641,41273,35385,1673,41,611,938
13441,92,95857,84351,28,123,53,70,0,0,92,92,0,145,145,0,0,0,0
13450,68,62000,81387,50,217,158,59,3,1.4,99,68,31,251,251,0,0,0,0
13452,1878,65890,76388,1153,4724,2419,2305,835,17.7,2216,1878,338,4850,4486,16,1,0,83
13454,335,100156,83950,271,743,333,410,83,11.2,418,335,83,754,705,0,0,0,5
13455,25,-,N,25,71,46,25,0,0,25,25,0,71,63,0,0,0,0
13456,1539,90893,104867,1098,4103,2041,2062,266,6.5,1549,1539,10,4103,3858,34,0,65,2
13457,27,-,37493,7,38,23,15,13,34.2,55,27,28,38,38,0,0,0,0
13459,789,64115,75737,535,2031,977,1054,382,18.8,992,789,203,2034,1898,24,13,4,6
13460,1615,63316,79577,1246,4286,2224,2062,376,8.8,1923,1615,308,4286,3992,18,0,34,40
13461,1378,88103,94642,867,3026,1416,1610,208,6.9,1428,1378,50,3046,2810,0,5,83,0
13464,495,55711,60983,337,1135,600,535,139,12.2,704,495,209,1154,1103,1,1,0,3
13468,115,61979,65690,64,301,151,150,28,9.3,156,115,41,305,283,0,0,0,22
13469,441,108798,124962,265,1107,458,649,83,7.5,441,441,0,1107,1052,0,0,55,0
13470,263,64028,76333,177,771,395,376,276,35.8,621,263,358,771,745,0,0,0,0
13471,1041,67898,82125,788,2601,1227,1374,201,7.7,1232,1041,191,2692,2611,4,0,14,2
13472,115,-,81804,95,277,118,159,0,0,343,115,228,277,277,0,0,0,0
13473,411,100477,100836,346,1048,582,466,34,3.2,526,411,115,1060,971,5,0,0,74
13475,27,77917,104081,17,49,17,32,0,0,27,27,0,49,41,0,0,0,0
13476,1191,63480,79544,701,2520,1317,1203,224,8.9,1307,1191,116,2540,2413,50,0,19,9
13477,600,63500,116492,330,1461,769,692,170,11.6,640,600,40,1468,1455,0,0,0,0
13478,1436,77195,94347,954,3331,1816,1515,310,9.3,1547,1436,111,3331,3253,0,3,26,0
13480,1344,78125,91693,917,3373,1649,1724,203,6,1436,1344,92,3454,3255,5,0,23,19
13482,29,56477,61600,26,73,26,47,0,0,55,29,26,73,73,0,0,0,0
13483,130,113000,91257,121,385,214,171,58,15.1,174,130,44,405,395,5,0,0,5
13484,49,-,N,26,103,26,77,23,22.3,49,49,0,103,103,0,0,0,0
13485,557,67989,81521,398,1706,831,875,319,18.7,653,557,96,1715,1674,2,0,7,0
13486,308,84792,104593,193,685,326,359,85,12.4,386,308,78,691,613,0,0,0,0
13488,72,61250,67085,32,130,52,78,8,6.2,128,72,56,130,130,0,0,0,0
13489,188,87115,100853,124,508,283,225,10,2,255,188,67,508,494,0,0,6,0
13490,483,98750,122040,423,1346,832,514,0,0,483,483,0,1346,1339,0,0,0,0
13491,1298,72500,91241,875,3531,1659,1872,461,13.1,1526,1298,228,3570,3354,5,0,13,8
13492,4787,84543,106767,3160,11170,5241,5929,933,8.4,4983,4787,196,11233,10366,245,0,0,151
13493,828,60735,69380,546,2347,1264,1083,464,19.8,971,828,143,2355,2267,5,3,1,12
13494,127,100208,95372,89,312,175,137,9,2.9,559,127,432,312,241,0,0,21,0
13495,918,63517,79895,420,1808,947,861,91,5,965,918,47,1889,1766,2,0,20,0
13501,15230,49771,67465,9139,39298,19164,20134,11493,29.2,17071,15230,1841,40235,20505,6045,152,5594,2069
13502,13700,59530,75798,7703,31967,16066,15901,6414,20.1,15337,13700,1637,33241,24740,3296,33,1654,1344
13601,16401,57503,76542,9379,36173,18319,17854,6386,17.7,18653,16401,2252,37409,31161,1709,161,869,946
13602,0,-,-,0,0,0,0,0,-,6,0,6,2700,1460,512,47,199,157
13603,5106,64028,74931,4335,13936,7383,6553,1131,8.1,5329,5106,223,13973,9248,1578,173,569,723
13605,2013,70947,98053,1340,5090,2674,2416,368,7.2,2497,2013,484,5106,4659,175,10,4,6
13606,883,90694,98236,682,2341,1262,1079,338,14.4,930,883,47,2397,2339,10,1,1,0
13607,1070,58167,138388,556,2041,1142,899,153,7.5,2079,1070,1009,2061,1962,37,15,9,31
13608,712,75673,85111,542,1845,969,876,257,13.9,852,712,140,1845,1660,17,14,0,22
13611,123,54750,62700,94,265,115,150,5,1.9,201,123,78,265,265,0,0,0,0
13612,1239,67106,89138,778,2940,1472,1468,432,14.7,1458,1239,219,2940,2678,0,0,119,22
13613,1113,57026,73892,782,2711,1336,1375,549,20.3,1208,1113,95,2733,2650,12,19,0,0
13614,105,36250,51559,77,287,130,157,131,45.6,110,105,5,287,278,0,0,0,0
13615,239,78750,89354,175,534,244,290,19,3.6,297,239,58,538,502,20,0,0,2
13616,820,47110,62873,444,1560,664,896,331,21.2,820,820,0,1560,1312,129,0,0,20
13617,4423,72652,81547,2375,8824,4160,4664,1005,11.4,4645,4423,222,12294,10970,449,18,271,153
13618,762,61500,84893,469,1677,825,852,163,9.7,2244,762,1482,1696,1564,8,0,0,2
13619,4103,63549,82556,2762,10548,5287,5261,1665,15.8,4649,4103,546,10774,9225,268,7,91,318
13620,815,62574,69336,524,2150,970,1180,333,15.5,900,815,85,2150,2117,10,0,0,0
13621,255,63125,155561,199,683,335,348,310,45.4,345,255,90,683,681,0,0,0,0
13622,762,78136,98165,563,2066,974,1092,276,13.4,1335,762,573,2100,1905,92,0,9,0
13623,43,43977,49784,30,76,39,37,4,5.3,53,43,10,76,76,0,0,0,0
13624,1856,79167,108394,1066,3893,1968,1925,447,11.5,3431,1856,1575,4438,3819,312,33,39,100
13625,698,76711,90756,498,1689,843,846,170,10.1,1119,698,421,1689,1645,3,0,8,0
13626,933,75662,88136,696,2322,1299,1023,363,15.6,1167,933,234,2322,2172,11,3,9,0
13628,78,53750,63603,48,185,94,91,35,18.9,94,78,16,185,177,0,0,0,3
13630,412,67000,84357,304,1291,759,532,72,5.6,455,412,43,1307,1268,5,10,0,0
13632,24,-,N,14,128,56,72,10,7.8,46,24,22,128,128,0,0,0,0
13633,139,62917,67742,116,378,200,178,42,11.1,211,139,72,378,358,0,0,0,0
13634,1552,90461,100365,1179,3839,1933,1906,296,7.7,2046,1552,494,3866,3729,16,0,0,7
13635,438,74583,80022,321,1268,688,580,177,14,492,438,54,1283,1227,1,8,0,1
13636,56,52500,73650,42,184,83,101,37,20.1,56,56,0,184,178,1,0,2,0
13637,2248,62786,66950,1401,5164,2969,2195,748,14.5,2491,2248,243,5280,3571,686,2,17,143
13638,106,79750,84655,61,172,98,74,21,12.2,106,106,0,172,155,0,0,0,0
13639,20,21346,21090,4,23,19,4,3,13,25,20,5,23,23,0,0,0,0
13640,141,92422,103658,87,290,136,154,11,3.8,810,141,669,305,301,0,0,0,0
13641,43,58875,69902,27,69,29,40,0,0,252,43,209,69,69,0,0,0,0
13642,3591,47452,64685,2144,8098,4094,4004,1661,20.5,4214,3591,623,9018,7816,369,74,8,208
13643,10,-,N,10,20,20,0,20,100,10,10,0,20,20,0,0,0,0
13645,0,-,-,0,0,0,0,0,-,0,0,0,0,0,0,0,0,0
13646,851,67344,86924,599,2352,1199,1153,612,26,2236,851,1385,2373,2266,8,3,5,0
13647,68,-,53613,32,159,83,76,37,23.3,68,68,0,159,145,0,0,0,14
13648,956,65000,74352,620,2184,1079,1105,189,8.7,1719,956,763,2236,2114,0,7,0,0
13649,22,-,N,22,58,28,30,0,0,39,22,17,58,58,0,0,0,0
13650,584,91458,112990,465,1256,640,616,211,16.8,1514,584,930,1268,1150,6,0,17,13
13651,74,98333,115749,46,127,67,60,6,4.7,143,74,69,127,126,0,0,0,0
13652,643,65203,78707,458,1805,955,850,385,21.3,898,643,255,1876,1694,3,0,4,5
13654,870,71389,82762,582,2354,1188,1166,529,22.5,1079,870,209,2370,2335,4,1,0,0
13655,1305,69089,72102,1018,3697,1705,1992,736,19.9,1314,1305,9,3705,424,24,2887,200,0
13656,1042,62250,75342,700,2942,1488,1454,474,16.1,1190,1042,148,2945,2683,145,0,12,10
13658,912,62102,88079,547,1995,991,1004,249,12.5,1028,912,116,2028,1967,0,0,0,0
13659,140,59423,78651,125,367,212,155,41,11.2,362,140,222,371,357,0,3,0,0
13660,688,71964,89035,546,1930,982,948,353,18.3,757,688,69,1953,1850,4,3,11,0
13661,743,83192,94310,579,1976,961,1015,170,8.6,1227,743,484,2043,1892,0,0,25,5
13662,7067,56987,78399,3627,15279,7640,7639,3026,19.8,7785,7067,718,15737,14837,106,94,97,5
13664,152,75909,83226,86,401,204,197,102,25.4,267,152,115,401,349,14,0,1,10
13665,287,59625,66539,174,686,312,374,155,22.6,345,287,58,686,667,13,0,0,0
13666,89,32679,40313,42,236,111,125,85,36,158,89,69,236,164,9,0,0,7
13667,1379,57114,68937,1080,3460,1769,1691,709,20.5,1597,1379,218,3460,3218,4,56,11,0
13668,1333,78286,87450,938,3304,1638,1666,438,13.3,1494,1333,161,3313,3165,25,14,0,20
13669,5966,66488,80065,3577,14106,6947,7159,2300,16.3,7419,5966,1453,15615,14220,656,56,79,202
13670,166,32500,46551,126,382,188,194,91,23.8,409,166,243,382,374,0,1,1,0
13672,178,73448,69737,122,408,188,220,35,8.6,418,178,240,408,393,0,0,0,0
13673,714,75758,87259,529,1803,904,899,234,13,871,714,157,1983,1721,19,9,29,14
13674,61,-,73039,27,154,93,61,17,11,61,61,0,154,154,0,0,0,0
13675,16,-,N,11,51,16,35,0,0,38,16,22,51,46,0,0,0,0
13676,5221,56900,76430,2594,11483,5712,5771,1983,17.3,5955,5221,734,13408,12155,257,26,406,72
13678,19,-,N,0,19,0,19,0,0,47,19,28,19,19,0,0,0,0
13679,468,102826,118046,379,1133,625,508,118,10.4,1325,468,857,1169,1102,0,2,22,0
13680,446,73000,75849,353,1412,694,718,388,27.5,502,446,56,1417,1385,0,0,7,0
13681,382,46797,56821,250,941,497,444,193,20.5,461,382,79,941,881,1,0,0,5
13682,299,84375,95782,217,795,410,385,44,5.5,343,299,44,795,744,0,0,4,0
13683,19,-,N,19,58,24,34,58,100,19,19,0,58,0,0,58,0,0
13684,458,56250,67015,296,1105,540,565,259,23.4,711,458,253,1105,1058,15,2,3,0
13685,1061,85195,93658,626,2226,1099,1127,252,11.3,1444,1061,383,2234,2054,19,2,14,23
13687,195,43355,69294,118,415,246,169,67,16.1,529,195,334,421,417,0,4,0,0
13690,272,58611,77191,164,644,369,275,186,28.9,477,272,205,651,539,26,10,0,8
13691,1173,75750,88400,749,3112,1799,1313,290,9.3,1692,1173,519,3172,2655,30,10,80,6
13692,80,161500,288273,70,216,111,105,0,0,515,80,435,216,216,0,0,0,0
13693,160,44375,66543,99,315,147,168,26,8.3,1019,160,859,315,310,0,0,5,0
13694,526,77308,92739,343,1232,534,698,138,11.2,607,526,81,1232,1139,7,4,8,0
13695,48,116250,112410,38,114,58,56,10,8.8,161,48,113,169,169,0,0,0,0
13696,89,55401,43379,36,188,90,98,0,0,89,89,0,188,188,0,0,0,0
13697,850,73324,115004,598,1951,945,1006,139,7.1,877,850,27,1951,1840,0,0,0,0
13699,0,-,-,0,0,0,0,0,-,4,0,4,2123,1685,139,0,168,40
13730,1280,61466,68378,737,2752,1291,1461,343,12.5,1595,1280,315,2763,2605,10,1,24,4
13731,548,76429,104148,331,1102,568,534,141,12.8,1165,548,617,1102,1020,0,0,9,0
13732,3056,89180,122961,2107,7430,3783,3647,629,8.5,3162,3056,106,7438,6784,83,0,137,149
13733,2315,59019,71432,1284,5259,2897,2362,528,10,2637,2315,322,5265,5095,26,0,19,13
13734,909,66343,71867,646,2186,1220,966,223,10.2,959,909,50,2243,2124,53,5,0,1
13736,793,64934,83460,567,1884,946,938,229,12.2,868,793,75,1887,1800,0,0,0,38
13738,8,-,N,8,22,14,8,0,0,38,8,30,22,22,0,0,0,0
13739,341,61719,80008,201,792,410,382,85,10.7,564,341,223,792,770,0,0,13,0
13740,252,78333,121808,160,607,371,236,68,11.2,491,252,239,607,539,12,1,4,9
13743,1294,56919,82953,758,2893,1444,1449,447,15.5,1474,1294,180,2893,2768,0,0,8,11
13744,425,63125,86373,316,1283,642,641,360,28.1,472,425,47,1284,1262,1,0,0,1
13746,1061,58250,88375,731,2427,1260,1167,419,17.3,1145,1061,84,2432,2140,4,1,11,18
13747,0,-,-,0,0,0,0,0,-,0,0,0,0,0,0,0,0,0
13748,1735,68486,81214,1080,3722,2016,1706,296,8,1894,1735,159,3722,3326,23,0,0,277
13750,235,64940,93009,154,588,291,297,20,3.4,499,235,264,588,578,0,0,0,0
13751,93,154761,206606,93,334,124,210,0,0,108,93,15,334,334,0,0,0,0
13752,364,71667,130650,175,913,584,329,149,16.3,565,364,201,913,876,0,0,3,2
13753,1854,70991,91006,1136,4042,2014,2028,402,9.9,2339,1854,485,5629,5092,89,0,137,107
13754,1205,59583,77608,797,2793,1397,1396,528,18.9,1990,1205,785,2793,2677,17,1,11,28
13755,346,49205,63879,211,737,338,399,171,23.2,714,346,368,737,688,0,7,0,31
13756,295,71458,86472,182,649,324,325,43,6.6,669,295,374,665,646,13,0,5,0
13757,511,72557,80201,293,1118,545,573,69,6.2,675,511,164,1121,1070,0,0,0,0
13760,19350,63242,85287,11130,42333,20825,21508,6350,15,20988,19350,1638,42880,36627,1839,110,818,528
13774,95,68083,80980,85,230,114,116,0,0,167,95,72,230,211,0,0,0,0
13775,794,76875,101194,490,1821,1063,758,205,11.3,1041,794,247,1839,1686,7,0,3,40
13776,170,72000,110402,109,395,204,191,26,6.6,237,170,67,395,374,0,0,5,0
13777,166,71500,96181,144,445,246,199,16,3.6,230,166,64,445,445,0,0,0,0
13778,2244,67050,83421,1354,5044,2520,2524,570,11.3,2702,2244,458,5139,4849,16,1,21,115
13780,330,75278,106046,210,842,341,501,41,4.9,553,330,223,842,775,0,0,0,0
13782,316,51719,76943,189,797,425,372,93,11.7,643,316,327,797,746,7,1,0,1
13783,1036,56176,70005,588,2190,1146,1044,262,12,1918,1036,882,2200,2055,29,0,56,20
13784,142,73265,58289,129,373,214,159,122,32.7,147,142,5,383,329,0,0,0,0
13786,214,50833,71283,108,438,249,189,59,13.5,310,214,96,440,375,11,0,9,0
13787,1366,66733,75275,723,3120,1771,1349,228,7.3,1678,1366,312,3120,2868,2,0,68,73
13788,413,95329,105277,274,950,500,450,125,13.2,646,413,233,950,827,27,0,14,4
13790,8388,54764,75643,4217,18062,8714,9348,3316,18.4,9585,8388,1197,18560,14140,1136,19,1530,115
13795,1497,56847,74740,863,3172,1362,1810,506,16,1547,1497,50,3180,2490,128,0,88,311
13796,401,63750,88655,250,908,446,462,62,6.8,566,401,165,915,850,7,1,0,18
13797,808,71250,87618,584,2105,1031,1074,418,19.9,856,808,48,2105,2022,11,0,0,0
13801,684,66985,85427,463,1524,850,674,210,13.8,1042,684,358,1533,1471,4,0,0,4
13802,605,-,59970,260,1206,552,654,513,42.5,611,605,6,1206,1193,0,0,0,0
13803,1505,62537,79663,1018,3881,1859,2022,547,14.1,1715,1505,210,3936,3794,0,2,11,5
13804,110,58056,57527,63,255,145,110,52,20.4,209,110,99,266,265,0,0,0,0
13806,66,-,91823,45,168,85,83,25,14.9,70,66,4,168,98,0,0,10,6
13807,471,86250,101621,345,1260,578,682,99,7.9,719,471,248,1260,1163,9,0,57,0
13808,586,60682,96449,364,1476,742,734,165,11.2,751,586,165,1486,1430,4,5,0,0
13809,670,56071,66184,383,1688,724,964,194,11.5,843,670,173,1688,1628,0,0,0,0
13810,510,90577,99367,323,1166,547,619,200,17.2,648,510,138,1195,1104,3,0,3,2
13811,1716,80900,90561,1154,4102,2062,2040,390,9.5,1854,1716,138,4102,3850,14,0,82,0
13812,912,74450,95660,641,2313,1147,1166,72,3.1,997,912,85,2313,2275,0,0,0,0
13813,308,83952,88655,252,1148,633,515,5,0.4,412,308,104,1148,1131,8,0,0,0
13814,8,-,N,5,28,19,9,0,0,8,8,0,28,16,0,0,0,0
13815,5554,59757,81738,3254,12435,6088,6347,1648,13.3,6445,5554,891,12855,11627,152,38,74,431
13820,8156,66217,84736,4648,18360,9280,9080,3384,18.4,10083,8156,1927,22954,19710,1218,65,402,424
13825,1232,73966,83869,754,2785,1583,1202,180,6.5,1573,1232,341,2785,2524,19,0,98,9
13826,39,-,N,6,68,62,6,0,0,39,39,0,68,62,0,0,0,0
13827,4770,70796,98754,2991,11397,5574,5823,1973,17.3,5108,4770,338,11713,10984,106,0,136,160
13830,1981,62267,73700,1338,4715,2375,2340,606,12.9,2452,1981,471,4826,4602,45,0,38,57
13832,193,70625,84644,144,513,238,275,88,17.2,286,193,93,513,512,0,0,0,1
13833,1479,58533,82000,1071,4026,2134,1892,1076,26.7,1741,1479,262,4176,3967,0,7,14,0
13834,65,52974,45512,18,108,48,60,0,0,65,65,0,108,108,0,0,0,0
13835,527,71688,84243,315,1182,559,623,74,6.3,612,527,85,1182,1144,0,0,14,0
13838,1705,51287,61804,882,4163,1935,2228,903,21.7,2126,1705,421,4185,3609,81,0,0,0
13839,528,52292,70586,374,1360,758,602,223,16.4,877,528,349,1362,1225,0,0,10,24
13841,188,53125,82585,118,394,174,220,72,18.3,274,188,86,394,367,4,0,11,0
13842,218,78333,98311,123,569,295,274,82,14.4,353,218,135,607,494,32,30,9,9
13843,738,76583,89094,608,2001,947,1054,161,8,913,738,175,2014,1900,8,0,7,21
13844,195,66635,74734,152,491,250,241,86,17.5,247,195,52,543,534,0,0,0,0
13846,145,29609,38786,64,259,108,151,54,20.8,199,145,54,259,256,3,0,0,0
13847,12,-,N,2,15,13,2,0,0,12,12,0,15,15,0,0,0,0
13849,1897,55884,80864,1070,4333,1864,2469,566,13.1,2472,1897,575,4351,4129,3,3,83,0
13850,9392,81627,123346,5887,23288,11550,11738,3239,13.9,10427,9392,1035,23675,18679,531,30,2766,483
13856,2748,48852,67099,1656,5915,2940,2975,1472,24.9,3652,2748,904,5915,5336,289,0,19,0
13859,48,68182,70415,44,119,49,70,0,0,61,48,13,119,104,0,0,0,0
13860,87,138967,112084,65,266,127,139,0,0,87,87,0,266,266,0,0,0,0
13861,292,57047,81166,117,450,296,154,1,0.2,317,292,25,450,412,0,28,0,0
13862,1468,61623,80807,964,3667,1849,1818,532,14.5,1674,1468,206,3667,3504,48,0,0,15
13863,177,71188,78522,98,430,229,201,56,13,310,177,133,430,403,2,0,14,0
13864,763,53015,63689,384,1421,657,764,416,29.3,763,763,0,1421,1056,36,0,0,309
13865,2584,71302,79479,1765,5771,3130,2641,585,10.1,3127,2584,543,5823,5532,44,0,12,2
13901,8641,54165,77248,4450,19530,9158,10372,4358,22.3,10148,8641,1507,19730,16076,1212,55,407,564
13902,0,-,-,0,0,0,0,0,-,0,0,0,6921,5946,31,0,824,92
13903,7858,61244,81758,4383,17503,8346,9157,2893,16.5,8620,7858,762,17528,14164,1689,0,213,292
13904,3644,56794,66982,2168,8801,4321,4480,1787,20.3,3962,3644,318,9138,6760,1183,0,250,529
13905,11572,53757,80701,5119,27080,13801,13279,8389,31,13774,11572,2202,28370,19890,3018,51,2868,607
14001,3994,73786,88777,2475,9063,4185,4878,527,5.8,4477,3994,483,9122,8548,50,35,59,41
14004,4235,88011,99244,3112,10279,5210,5069,512,5,4386,4235,151,11312,10266,695,2,33,129
14005,643,94931,113058,475,1745,920,825,81,4.6,674,643,31,1788,1558,2,2,0,29
14006,4153,62019,74015,2610,9308,4373,4935,1221,13.1,5012,4153,859,9354,8715,190,6,118,22
14008,632,68452,83599,417,1484,663,821,57,3.8,658,632,26,1484,1181,60,0,6,84
14009,2727,61715,80616,1565,5787,2771,3016,599,10.4,2877,2727,150,5787,5453,0,0,133,0
14011,2185,73750,92197,1409,5229,2658,2571,466,8.9,2332,2185,147,7382,5695,1073,43,70,371
14012,1132,72333,87930,836,2940,1497,1443,403,13.7,1375,1132,243,2944,2370,246,103,20,7
14013,631,73350,79346,420,1479,693,786,179,12.1,653,631,22,1612,1155,17,191,18,0
14020,10371,59834,80363,5492,21562,10862,10700,2688,12.5,10930,10371,559,22209,19581,647,9,251,327
14024,620,73125,85880,406,1596,819,777,205,12.8,831,620,211,1606,1507,17,0,22,17
14025,1529,109542,125180,1122,3375,1679,1696,170,5,1692,1529,163,3445,3124,7,0,63,119
14026,307,86023,92267,151,561,265,296,0,0,376,307,69,561,538,0,0,0,0
14027,57,-,114305,24,143,82,61,34,23.8,57,57,0,143,126,0,14,0,0
14028,670,73571,86129,377,1363,682,681,77,5.6,794,670,124,1377,1274,11,0,10,1
14029,19,-,77605,9,31,14,17,11,35.5,40,19,21,31,31,0,0,0,0
14030,743,84792,90221,493,2044,995,1049,274,13.4,791,743,48,2051,1969,4,24,19,0
14031,4129,99639,147490,2616,9545,4830,4715,927,9.7,4539,4129,410,9741,8602,60,0,87,422
14032,3786,160079,199315,2961,10285,5291,4994,406,3.9,3936,3786,150,10359,9588,103,14,193,11
14033,660,84167,94304,466,1412,701,711,103,7.3,727,660,67,1412,1393,0,0,0,0
14034,789,61384,86227,479,1738,899,839,99,5.7,865,789,76,2175,1795,245,19,27,55
14035,26,91250,99569,18,69,41,28,2,2.9,47,26,21,69,69,0,0,0,0
14036,2396,91806,98208,1733,5745,2917,2828,491,8.5,2521,2396,125,5745,5591,74,0,0,7
14037,382,87955,111276,243,923,452,471,75,8.1,382,382,0,923,828,0,0,0,0
14039,49,-,65727,27,101,46,55,10,9.9,49,49,0,101,93,0,0,0,0
14040,600,85820,98718,452,1633,874,759,33,2,620,600,20,1635,1621,0,0,0,0
14041,86,-,72656,39,204,119,85,42,20.6,114,86,28,204,136,0,0,14,0
14042,1819,50625,68778,1200,4160,2066,2094,847,20.4,2052,1819,233,4207,3944,14,5,0,102
14043,11224,73373,89338,6361,24752,11891,12861,1746,7.1,11743,11224,519,24799,22816,573,37,359,242
14047,2571,76525,88743,1615,6072,3217,2855,907,14.9,2707,2571,136,6072,5823,58,13,0,15
14048,6775,52971,65354,3893,14754,7766,6988,3275,22.2,7506,6775,731,14949,10048,1015,78,22,1965
14051,8211,126895,154579,6054,20333,10235,10098,826,4.1,8424,8211,213,20333,16917,420,31,1903,231
14052,7090,103474,129776,5172,17070,8413,8657,522,3.1,7603,7090,513,17501,16732,81,45,59,61
14054,555,80903,100968,407,1359,757,602,105,7.7,571,555,16,1359,1194,36,3,0,18
14055,682,48621,85352,343,1300,594,706,103,7.9,709,682,27,1300,1296,0,0,0,4
14056,104,-,36914,95,205,48,157,0,0,104,104,0,205,205,0,0,0,0
14057,3090,88750,101266,2139,7479,3940,3539,719,9.6,3230,3090,140,7632,7347,82,6,63,52
14058,865,102039,96861,685,2649,1334,1315,189,7.1,915,865,50,2649,2051,18,1,0,101
14059,3630,101698,152268,2714,9413,4875,4538,260,2.8,3803,3630,173,9413,9189,6,6,25,13
14060,167,79145,82629,116,346,201,145,13,3.8,215,167,48,346,317,0,1,0,0
14061,36,-,99353,31,101,62,39,15,14.9,36,36,0,101,86,0,5,0,0
14062,1330,74667,77605,864,3220,1521,1699,467,14.5,1489,1330,159,3220,2988,6,1,35,0
14063,5309,55629,77262,2860,10757,5188,5569,2124,19.7,5861,5309,552,12722,10760,502,8,296,557
14065,670,61125,80479,460,1761,834,927,316,17.9,738,670,68,1769,1684,0,1,42,0
14066,471,69688,78771,301,990,480,510,101,10.2,531,471,60,1004,965,0,0,9,4
14067,1750,90625,108163,1119,4000,1818,2182,208,5.2,1933,1750,183,4063,3800,115,55,2,12
14068,3189,120021,134981,2072,8122,4171,3951,1184,14.6,3439,3189,250,8504,6877,349,0,498,10
14069,251,56360,79629,138,492,215,277,50,10.2,262,251,11,492,432,2,0,0,2
14070,2216,51620,70182,1318,5244,2577,2667,613,11.7,2589,2216,373,5437,4572,75,568,14,47
14072,8874,107036,129756,6048,21344,10659,10685,1066,5,9053,8874,179,21441,19467,435,70,435,197
14075,19527,82083,105585,12099,43962,20457,23505,2720,6.2,20164,19527,637,44588,41382,618,95,260,252
14080,1931,76674,100234,1222,4425,2322,2103,413,9.3,2108,1931,177,4434,4297,36,0,0,0
14081,1085,63672,78124,731,2573,1326,1247,491,19.1,1470,1085,385,2736,1664,51,614,55,28
14082,175,102563,112651,151,566,326,240,10,1.8,175,175,0,566,517,38,1,0,0
14083,10,-,N,10,20,10,10,0,0,10,10,0,20,20,0,0,0,0
14085,3044,124286,131534,2468,8332,4050,4282,359,4.3,3135,3044,91,8439,7909,59,0,47,38
14086,15124,95949,116497,9788,35389,17302,18087,1245,3.5,15486,15124,362,35659,33877,496,46,289,144
14091,522,80086,116328,354,1402,711,691,373,26.6,588,522,66,1402,837,55,213,6,0
14092,4997,67835,94524,2636,10090,4783,5307,1071,10.6,5241,4997,244,10318,9329,41,128,120,16
14094,21548,73354,93874,13596,49856,24051,25805,5507,11,23283,21548,1735,50526,43234,2982,113,348,606
14098,1124,73750,88257,856,2958,1524,1434,463,15.7,1591,1124,467,2968,2836,20,0,0,30
14101,769,70083,72297,516,1883,954,929,369,19.6,1073,769,304,1984,1884,0,0,0,5
14102,655,122659,135701,520,1894,1109,785,16,0.8,655,655,0,1894,1801,0,0,0,0
14103,4464,68781,80209,2851,10602,5425,5177,1087,10.3,4769,4464,305,10836,9076,423,85,191,523
14105,1917,85208,93034,1491,5105,2549,2556,274,5.4,2149,1917,232,5113,4966,5,19,0,6
14108,2165,72977,90885,1321,5166,2738,2428,372,7.2,2354,2165,189,5301,5046,32,21,9,16
14109,0,-,-,0,0,0,0,0,-,0,0,0,1341,877,208,13,42,96
14111,1302,79474,87844,812,3092,1624,1468,281,9.1,1390,1302,88,3125,2981,2,24,0,49
14112,12,-,N,12,38,26,12,0,0,12,12,0,38,38,0,0,0,0
14113,282,95313,89981,175,646,366,280,34,5.3,367,282,85,646,640,0,0,0,2
14120,19314,76608,93533,12040,43931,21783,22148,4453,10.1,20367,19314,1053,44379,40662,1026,32,406,445
14125,1449,63603,76751,978,3662,1831,1831,752,20.5,1470,1449,21,3668,3226,64,11,0,113
14126,94,148462,219661,57,301,204,97,0,0,269,94,175,301,301,0,0,0,0
14127,13050,106071,138960,8448,30465,15196,15269,2140,7,13412,13050,362,30783,28436,399,80,42,773
14129,467,68036,83654,283,1228,616,612,177,14.4,515,467,48,1228,925,16,121,2,66
14130,40,69000,67005,32,110,65,45,4,3.6,53,40,13,110,106,1,0,0,0
14131,2007,91424,105567,1487,5311,2560,2751,332,6.3,2198,2007,191,5339,5021,83,0,0,16
14132,2266,102244,129400,1707,6282,3197,3085,412,6.6,2372,2266,106,6432,5805,34,120,310,8
14134,30,-,54137,16,57,24,33,14,24.6,30,30,0,57,57,0,0,0,0
14135,53,-,156711,27,96,61,35,21,21.9,73,53,20,109,109,0,0,0,0
14136,2257,68875,80341,1440,5254,2519,2735,614,11.7,2699,2257,442,5274,4867,60,30,0,28
14138,790,57239,68894,529,1980,1049,931,523,26.4,940,790,150,2019,1762,0,6,0,216
14139,837,78317,95578,562,2066,1099,967,143,6.9,871,837,34,2093,1999,26,0,0,15
14141,3216,71837,104813,2132,7498,4042,3456,724,9.7,3675,3216,459,7624,7390,47,13,24,29
14143,482,94688,97923,350,1212,698,514,89,7.3,550,482,68,1230,1044,25,0,0,0
14145,535,87708,96979,370,1245,660,585,54,4.3,552,535,17,1275,1113,0,0,0,162
14150,19397,70294,85230,10601,41410,20184,21226,4171,10.1,20152,19397,755,41585,36741,1526,40,693,351
14166,75,96616,125875,75,182,106,76,0,0,281,75,206,182,182,0,0,0,0
14167,840,69110,80901,535,1931,1075,856,188,9.7,936,840,96,1931,1814,19,0,5,0
14168,39,73438,98067,27,90,36,54,8,8.9,39,39,0,90,70,0,8,0,0
14169,74,59149,61568,0,84,57,27,0,0,74,74,0,84,84,0,0,0,0
14170,841,112665,142605,676,2200,1065,1135,62,2.8,964,841,123,2200,2044,0,0,0,0
14171,791,70417,88473,505,1736,869,867,98,5.6,1008,791,217,1736,1528,73,7,0,0
14172,1375,76094,88253,901,3015,1525,1490,366,12.1,1702,1375,327,3019,2745,12,24,0,10
14173,87,-,61763,65,183,70,113,7,3.8,87,87,0,183,147,0,0,0,0
14174,2425,78922,100549,1762,5768,2937,2831,470,8.1,2601,2425,176,5768,5293,40,58,75,0
14201,5954,34204,59801,2098,12160,6129,6031,5426,44.6,7172,5954,1218,12545,5862,2152,158,202,2605
14202,2204,47990,102918,597,3463,1753,1710,591,17.1,2452,2204,248,3764,1952,941,13,150,516
14203,1690,48529,59247,334,2523,1201,1322,1022,40.5,1712,1690,22,2526,874,1119,9,184,155
14204,4326,26000,42767,1500,7745,3192,4553,2692,34.8,5514,4326,1188,7748,1907,4755,6,8,755
14206,9584,46842,60710,4997,22312,11217,11095,5247,23.5,10677,9584,1093,22427,15289,2858,94,932,1526
14207,10356,38951,54310,6048,25699,12482,13217,8272,32.2,11317,10356,961,25731,11256,4590,92,3805,2314
14208,4667,46940,58835,2331,11423,4894,6529,3194,28,5884,4667,1217,12731,2056,9303,13,737,76
14209,4186,49359,79438,1404,7460,3574,3886,1863,25,4729,4186,543,8373,4591,2792,80,263,250
14210,7140,51059,61424,3549,15406,7446,7960,3799,24.7,7813,7140,673,15454,12440,1314,29,207,208
14211,9685,34490,57154,5395,23824,10760,13064,8267,34.7,11498,9685,1813,23951,2501,14266,83,4733,1188
14212,4924,35517,52008,2771,13567,6497,7070,5568,41,5935,4924,1011,13603,4665,3844,127,3385,462
14213,9305,52597,70800,4605,22374,11201,11173,5977,26.7,11397,9305,2092,23072,11680,4284,143,2814,1896
14214,8422,56573,80376,4121,19909,10403,9506,5034,25.3,9280,8422,858,21162,10236,6774,62,2284,504
14215,17139,43326,59485,9983,41384,18410,22974,12433,30,19203,17139,2064,42813,6782,29292,76,2850,1328
14216,11859,70260,93643,5172,23159,10849,12310,3210,13.9,12773,11859,914,23221,16855,3731,133,297,1008
14217,10855,72205,86015,5137,22170,10432,11738,2463,11.1,11280,10855,425,22566,19013,1231,87,188,327
14218,8755,50484,66354,4770,20552,9667,10885,4415,21.5,9478,8755,723,20661,15555,2779,78,156,1070
14219,5298,75465,83065,3175,10894,5170,5724,1372,12.6,5612,5298,314,10894,9687,169,3,206,270
14220,10297,68337,83687,5941,23674,11492,12182,2903,12.3,11286,10297,989,23786,19260,1429,83,466,1040
14221,24193,101275,127872,14590,54029,26234,27795,3685,6.8,25281,24193,1088,55153,46896,954,62,4266,720
14222,6817,83692,120237,2410,13682,6876,6806,1288,9.4,7355,6817,538,15440,11730,1859,123,378,304
14223,10247,83528,102204,6126,22308,10997,11311,1993,8.9,10586,10247,339,22363,19032,1047,10,1097,179
14224,18448,76250,93145,10651,40866,19872,20994,3160,7.7,19286,18448,838,41101,38506,1024,28,156,317
14225,15739,65562,78542,8465,33476,16363,17113,3406,10.2,16253,15739,514,33801,25210,4442,70,891,817
14226,12614,83023,116922,7139,28716,14161,14555,2659,9.3,13282,12614,668,29482,22323,2950,29,2196,335
14227,10075,67349,80300,5538,21299,9958,11341,1397,6.6,10476,10075,401,21669,18296,1716,19,675,286
14228,10119,72426,92879,4902,23928,12049,11879,3830,16,10601,10119,482,24345,18426,1319,109,3262,100
14260,0,-,-,0,0,0,0,0,-,0,0,0,857,487,167,6,143,21
14261,0,-,-,0,0,0,0,0,-,0,0,0,4970,2584,796,53,883,160
14301,5924,37650,50662,2664,11260,5750,5510,3747,33.3,7285,5924,1361,11448,6946,2977,86,277,240
14302,115,-,N,0,115,0,115,115,100,130,115,15,209,92,105,0,0,0
14303,2871,45519,54729,1380,6155,2942,3213,1532,24.9,3505,2871,634,6210,3416,886,63,234,457
14304,12915,64756,80071,7945,28824,14447,14377,3578,12.4,13705,12915,790,28965,25200,1009,125,484,380
14305,7253,49588,68797,3953,16181,7926,8255,4049,25,8348,7253,1095,16433,9396,4060,184,200,379
14411,5052,53626,66752,2839,10980,5293,5687,2144,19.5,5683,5052,631,12479,10609,1090,61,17,159
14413,14,-,N,14,81,67,14,81,100,42,14,28,81,44,0,0,0,17
14414,2859,73964,103764,1843,6679,3284,3395,538,8.1,2950,2859,91,6722,6282,84,22,29,23
14415,42,-,74214,35,132,58,74,20,15.2,56,42,14,132,132,0,0,0,0
14416,1505,80298,93438,1069,3892,1985,1907,277,7.1,1620,1505,115,3908,3655,28,1,70,66
14418,450,53750,73450,281,1147,634,513,132,11.5,890,450,440,1147,996,2,0,142,0
14420,7657,69716,88575,4563,17602,8489,9113,2480,14.1,8245,7657,588,20097,16894,1099,23,428,588
14422,638,81765,107648,486,1693,800,893,153,9,700,638,62,1693,1481,34,0,0,19
14423,2046,80129,102699,1371,4829,2367,2462,237,4.9,2166,2046,120,4829,4205,138,0,52,148
14424,12896,79135,105473,7431,28055,13581,14474,2367,8.4,14482,12896,1586,28851,26524,383,0,127,407
14425,5186,92010,104185,3580,13382,6559,6823,1163,8.7,5414,5186,228,13582,11946,423,0,209,21
14427,872,63571,73612,525,1875,994,881,269,14.3,1024,872,152,1875,1736,27,7,0,12
14428,3306,86711,104449,2215,7973,4062,3911,566,7.1,3491,3306,185,7986,7455,31,4,34,189
14432,2126,69750,90615,1319,5438,2437,3001,732,13.5,2347,2126,221,5583,4888,37,17,22,28
14433,1640,67656,76905,1086,4319,2273,2046,732,16.9,1784,1640,144,4319,4017,72,5,2,66
14435,1093,68472,116410,699,2392,1240,1152,300,12.5,1490,1093,397,2398,2189,0,0,0,12
14437,3983,64807,85893,2449,8957,4718,4239,939,10.5,4469,3983,486,8970,8408,120,1,68,195
14441,108,68571,79534,76,339,186,153,70,20.6,193,108,85,339,320,4,0,4,5
14445,3486,72250,76352,1805,7592,3954,3638,616,8.1,3661,3486,175,7604,6818,378,29,35,116
14450,18398,109543,130922,11945,42635,20611,22024,2146,5,19054,18398,656,43063,38903,705,8,1016,197
14453,0,-,-,0,0,0,0,0,-,0,0,0,0,0,0,0,0,0
14454,3432,66629,92516,1846,8040,3568,4472,1852,23,3937,3432,505,11044,9615,351,29,388,193
14456,8183,74691,96886,4491,17522,8808,8714,2516,14.4,9087,8183,904,19864,15725,1322,21,431,931
14462,264,77368,82870,186,765,348,417,168,22,273,264,9,765,650,0,0,0,0
14463,122,48889,64657,40,258,68,190,27,10.5,137,122,15,258,252,0,2,4,0
14464,2650,75583,93211,1970,6676,3355,3321,772,11.6,2907,2650,257,6725,6367,108,0,0,14
14466,643,101607,121543,576,1656,882,774,23,1.4,672,643,29,1656,1625,0,0,0,11
14467,4490,88548,95454,2838,10449,4898,5551,837,8,4561,4490,71,10468,8400,651,3,936,50
14468,6981,97476,111737,5427,19103,9778,9325,1074,5.6,7245,6981,264,19119,17465,280,23,25,235
14469,2623,70914,92440,1747,5785,2852,2933,449,7.8,2904,2623,281,5789,5627,6,10,12,12
14470,3333,63201,100147,2167,7765,3975,3790,798,10.3,3436,3333,103,7765,7155,151,4,55,71
14471,1339,75873,84629,840,2737,1487,1250,102,3.7,2034,1339,695,2792,2610,118,0,6,12
14472,3466,128456,152942,2573,9123,4641,4482,324,3.6,3524,3466,58,9156,8412,111,0,100,29
14475,105,121382,164186,80,253,147,106,10,4,105,105,0,253,249,0,0,4,0
14476,946,92708,100070,701,2456,1303,1153,117,4.8,1016,946,70,2456,2183,7,0,2,37
14477,666,93558,111218,520,1779,922,857,105,5.9,851,666,185,1779,1660,35,0,1,9
14478,340,93235,135987,227,639,362,277,6,0.9,775,340,435,1393,1361,11,0,0,10
14479,31,-,N,17,61,17,44,14,23,31,31,0,61,61,0,0,0,0
14480,266,54618,79299,137,532,192,340,53,10,504,266,238,532,445,0,0,0,0
14481,802,76154,91544,551,1879,929,950,192,10.2,827,802,25,1883,1757,4,3,0,11
14482,3705,77581,82941,2158,8036,3827,4209,715,8.9,3889,3705,184,8233,7861,103,5,31,8
14485,1601,79375,94524,1014,3927,2018,1909,403,10.3,1789,1601,188,4163,3762,26,0,75,62
14486,133,-,115715,73,374,107,267,81,21.7,133,133,0,374,212,6,0,0,0
14487,2260,90714,101543,1548,5509,2785,2724,310,5.6,2456,2260,196,5632,5375,2,0,0,53
14489,2672,67169,76482,1624,6777,3062,3715,966,14.3,3065,2672,393,7016,6179,176,47,0,152
14502,4607,83224,106696,3115,10471,5114,5357,910,8.7,4769,4607,162,10515,9370,138,0,313,67
14504,710,61172,75559,410,1646,789,857,178,10.8,743,710,33,1655,1539,15,3,38,0
14505,2095,86188,100058,1387,5098,2591,2507,420,8.2,2201,2095,106,5165,4789,0,6,11,249
14506,434,95625,148820,252,860,372,488,96,11.2,434,434,0,866,794,6,0,0,0
14507,472,74063,103048,322,1230,640,590,112,9.1,778,472,306,1233,1171,29,0,0,0
14510,1940,61099,76301,1060,4565,2395,2170,671,14.7,2190,1940,250,4781,4329,41,11,0,132
14511,168,54958,79139,154,529,308,221,0,0,168,168,0,529,459,0,0,0,0
14512,2016,69808,86983,1406,4891,2516,2375,823,16.8,2717,2016,701,4908,4683,6,12,38,6
14513,5876,61117,74835,3286,13274,6647,6627,2007,15.1,6202,5876,326,13501,11001,444,144,108,462
14514,2589,80453,100160,1590,5965,2886,3079,333,5.6,2715,2589,126,5979,5126,370,5,66,112
14515,93,-,73573,28,146,89,57,0,0,118,93,25,146,146,0,0,0,0
14516,829,71902,85889,483,2184,1179,1005,413,18.9,1062,829,233,2184,1932,154,0,38,34
14517,1147,58045,79530,663,2558,1377,1181,459,17.9,1207,1147,60,2588,2405,40,1,0,7
14519,5082,91331,103059,3591,12484,6211,6273,708,5.7,5281,5082,199,12487,11440,170,21,55,103
14521,1186,59700,87311,681,2920,1601,1319,583,20,1566,1186,380,3282,2859,262,2,2,77
14522,4023,80368,93824,2508,9230,4616,4614,722,7.8,4313,4023,290,9230,8692,67,10,150,46
14525,1028,81711,94636,700,2528,1300,1228,225,8.9,1083,1028,55,2532,2345,11,0,0,18
14526,7857,110566,131776,5437,19091,8978,10113,863,4.5,8231,7857,374,19348,17133,225,0,388,258
14527,4836,65212,87965,3137,12126,5728,6398,1618,13.3,6252,4836,1416,12444,11858,61,0,20,172
14529,35,70625,56143,26,76,40,36,9,11.8,35,35,0,76,76,0,0,0,0
14530,2415,66168,81705,1628,6069,3118,2951,667,11,2808,2415,393,6396,5518,301,11,0,389
14532,1680,71667,82376,979,3915,1986,1929,423,10.8,1873,1680,193,3933,3702,25,0,0,69
14533,707,68565,85892,474,1745,933,812,218,12.5,746,707,39,1754,1511,33,0,0,152
14534,12699,144832,200664,9700,33130,15861,17269,820,2.5,12913,12699,214,33361,27512,773,1,2758,299
14536,307,62348,65307,136,663,330,333,76,11.5,369,307,62,663,499,2,0,41,48
14537,126,-,79525,64,217,132,85,0,0,126,126,0,217,209,0,0,0,0
14539,47,121250,121870,27,115,38,77,0,0,47,47,0,115,115,0,0,0,0
14541,845,78125,95730,639,2494,1229,1265,415,16.6,1115,845,270,3523,2641,588,0,4,111
14542,20,-,N,20,33,0,33,0,0,20,20,0,33,33,0,0,0,0
14543,1368,118868,126920,970,3201,1643,1558,135,4.2,1379,1368,11,3301,2937,57,0,105,0
14544,925,58173,100414,676,2274,1069,1205,182,8,1256,925,331,2274,2156,3,0,19,0
14545,54,103250,102831,41,136,55,81,0,0,54,54,0,136,128,0,0,0,0
14546,1989,82578,96389,1165,4557,2274,2283,389,8.5,2225,1989,236,4585,4229,149,1,6,22
14548,1572,84943,103017,997,3671,1870,1801,372,10.1,1651,1572,79,3695,3331,12,0,3,268
14549,148,-,36397,108,404,108,296,269,66.6,264,148,116,404,404,0,0,0,0
14550,571,56250,74424,356,1265,574,691,141,11.1,651,571,80,1273,1261,0,0,0,7
14551,2344,53462,70185,1299,4880,2595,2285,946,19.4,2673,2344,329,4969,3849,588,29,4,102
14555,604,77500,101916,376,1206,670,536,78,6.5,1015,604,411,1206,1044,66,0,0,0
14556,0,-,-,0,17,13,4,6,35.3,0,0,0,902,463,317,17,2,61
14557,49,-,106427,44,139,55,84,0,0,64,49,15,139,103,0,0,11,0
14559,7136,91021,118562,4905,17628,8935,8693,931,5.3,7412,7136,276,17646,16357,233,21,49,157
14560,1069,74306,83336,658,2355,1191,1164,198,8.4,1279,1069,210,2392,2190,0,0,2,34
14561,943,76743,88896,612,2196,1123,1073,240,10.9,1004,943,61,2198,2148,13,0,0,0
14564,6762,111293,143405,4649,16224,7762,8462,537,3.3,7021,6762,259,16257,14735,221,0,594,67
14568,2593,103750,108574,1786,6023,2894,3129,235,3.9,2668,2593,75,6023,5485,34,0,91,246
14569,2953,61809,78211,1770,6218,3013,3205,878,14.1,3314,2953,361,6372,6141,56,0,0,60
14571,408,81000,92394,271,1001,515,486,124,12.4,631,408,223,1001,809,104,22,0,59
14572,1795,68125,84032,1283,4614,2265,2349,704,15.3,2288,1795,493,4745,4296,30,0,0,102
14580,23728,95499,120943,15030,53996,25672,28324,2855,5.3,24355,23728,627,54466,48428,1428,27,1695,270
14585,107,40074,60932,58,167,71,96,16,9.6,107,107,0,167,167,0,0,0,0
14586,4795,122833,123262,3246,12883,5922,6961,1755,13.6,5108,4795,313,13056,9162,866,5,1958,472
14588,0,-,-,0,0,0,0,0,-,0,0,0,0,0,0,0,0,0
14589,3093,84806,97716,2277,7898,4003,3895,602,7.6,3396,3093,303,7904,7243,190,2,0,85
14590,2330,56026,67646,1382,5213,2762,2451,1037,19.9,3383,2330,1053,5264,4747,99,27,7,165
14591,634,84750,96108,435,1453,767,686,114,7.8,686,634,52,1453,1329,0,0,0,56
14592,57,72344,87704,57,119,57,62,0,0,68,57,11,119,119,0,0,0,0
14604,1952,63672,89904,227,2649,1298,1351,590,22.3,2367,1952,415,2708,1586,308,0,245,176
14605,4454,23255,48240,2511,11589,5253,6336,5029,43.4,5141,4454,687,11796,2325,5856,25,644,1670
14606,10907,57287,74261,7073,27333,13575,13758,5281,19.3,11712,10907,805,27478,15164,7224,75,957,1717
14607,10936,56270,80090,2338,17114,8996,8118,2695,15.7,11971,10936,1035,17577,14043,1467,15,378,403
14608,5964,39537,55102,2313,12270,5751,6519,3896,31.8,6935,5964,971,12417,3637,6324,14,472,332
14609,17784,61933,76756,9631,39937,18166,21771,7406,18.5,19404,17784,1620,40171,19990,11644,100,829,3455
14610,7233,83260,130765,2993,13829,6586,7243,1658,12,7823,7233,590,14082,11635,916,16,388,350
14611,7246,29870,44626,4031,16999,8153,8846,6535,38.4,8292,7246,1046,17595,4249,10030,114,263,689
14612,15328,81598,97331,9318,34795,17384,17411,2436,7,16063,15328,735,35339,28778,3478,36,313,759
14613,5713,33370,48016,3287,14651,6446,8205,4874,33.3,6561,5713,848,14740,4192,7055,9,1165,645
14614,140,63452,88183,52,341,220,121,118,34.6,142,140,2,1112,357,607,16,10,16
14615,7880,53150,73533,4298,18243,8713,9530,3704,20.3,8258,7880,378,18255,9647,5472,22,503,1052
14616,11518,62564,76899,6346,26597,12830,13767,3889,14.6,12281,11518,763,26837,18956,3593,147,731,1269
14617,9300,89530,109833,6064,21228,9969,11259,1156,5.4,9747,9300,447,21287,18699,866,4,191,288
14618,8614,122647,188042,6041,21586,10644,10942,1185,5.5,9003,8614,389,24621,19911,1094,55,1976,217
14619,5376,66345,80095,3325,14144,6575,7569,2352,16.6,5891,5376,515,14223,3051,9782,8,197,118
14620,11956,59525,78013,3569,21079,10682,10397,4044,19.2,13060,11956,1104,22866,15755,2777,19,2027,849
14621,13090,36534,53781,7447,32647,15394,17253,10600,32.5,15013,13090,1923,33349,7914,14513,198,376,6218
14622,5848,73683,96260,3635,12794,6372,6422,1396,10.9,6047,5848,199,12794,10134,830,7,784,357
14623,8877,61088,74079,4070,19186,9965,9221,3240,16.9,9612,8877,735,25689,17859,2265,66,3754,163
14624,15421,86046,98536,10614,38022,18600,19422,3246,8.5,15865,15421,444,38834,31053,3647,29,1245,890
14625,4834,107246,132779,3005,10620,5315,5305,833,7.8,5153,4834,319,10667,9231,171,9,130,88
14626,12945,78785,96160,7454,29059,13778,15281,2266,7.8,13717,12945,772,29210,23480,2668,8,993,289
14627,0,-,-,0,0,0,0,0,-,0,0,0,3008,1989,239,15,527,36
14642,0,-,-,0,0,0,0,0,-,0,0,0,0,0,0,0,0,0
14701,17004,50909,65320,9297,38420,18436,19984,7784,20.3,19469,17004,2465,39207,34264,1150,49,168,1370
14706,2576,76029,92133,1717,6101,3110,2991,874,14.3,2828,2576,252,6118,5401,191,113,104,5
14707,58,38750,58040,14,108,56,52,30,27.8,95,58,37,113,104,0,0,0,0
14708,48,73750,68800,34,139,75,64,4,2.9,86,48,38,139,119,0,0,0,15
14709,525,51042,68952,333,1185,624,561,155,13.1,857,525,332,1190,1118,7,0,23,7
14710,1287,64782,84185,863,2912,1478,1434,274,9.4,2146,1287,859,2951,2854,0,23,0,0
14711,628,59828,71064,369,1850,871,979,178,9.6,896,628,268,1861,1827,0,3,1,0
14712,1477,77423,112800,916,3014,1537,1477,307,10.2,2273,1477,796,3079,2976,2,7,9,3
14714,195,102125,98779,165,556,288,268,69,12.4,241,195,46,556,548,0,0,7,0
14715,985,51641,62526,618,2359,1199,1160,490,20.8,1259,985,274,2374,2313,19,0,5,1
14716,714,54697,64117,467,1792,853,939,387,21.6,826,714,112,2343,1635,241,27,22,216
14717,327,77813,102425,189,612,358,254,68,11.1,1004,327,677,612,610,0,0,0,0
14718,726,58594,75646,494,1840,1026,814,245,13.3,927,726,201,1961,1708,169,3,10,22
14719,1399,61115,71927,854,3297,1756,1541,452,13.7,1859,1399,460,3334,3204,5,10,3,26
14720,346,43333,58023,191,829,418,411,114,13.8,376,346,30,853,739,2,17,6,27
14721,87,53984,60287,62,176,80,96,28,15.9,120,87,33,176,173,0,0,0,0
14722,133,-,156881,54,205,117,88,56,27.3,1271,133,1138,292,259,27,0,0,4
14723,430,63611,75163,308,1060,575,485,254,24,559,430,129,1060,1033,0,0,4,3
14724,953,77679,87612,740,3099,1525,1574,239,7.7,1288,953,335,3099,2988,3,0,10,4
14726,605,62679,72381,486,2681,1318,1363,643,24,754,605,149,2681,2640,2,1,0,12
14727,2083,67316,79606,1381,4971,2442,2529,551,11.1,2759,2083,676,5039,4810,7,17,54,43
14728,364,62143,100874,213,856,437,419,45,5.3,997,364,633,856,856,0,0,0,0
14729,380,70000,72463,198,763,416,347,85,11.1,535,380,155,768,745,8,0,0,11
14731,576,64091,81597,334,1193,629,564,123,10.3,2501,576,1925,1198,1166,1,7,0,0
14732,13,-,27231,8,26,18,8,5,19.2,25,13,12,26,26,0,0,0,0
14733,1413,56157,72774,883,3188,1547,1641,371,11.6,1626,1413,213,3201,2921,21,0,11,24
14735,916,66842,75119,691,2604,1271,1333,322,12.4,1300,916,384,2609,2551,0,3,20,0
14736,84,90500,112733,69,210,86,124,3,1.4,320,84,236,210,210,0,0,0,0
14737,1697,56780,74784,1108,4071,1910,2161,725,17.8,2546,1697,849,4071,3626,7,45,10,24
14738,1390,70000,72317,937,3496,1684,1812,469,13.4,1714,1390,324,3550,3430,0,8,0,3
14739,1030,51121,58869,595,2460,1305,1155,744,30.2,1455,1030,425,2494,2426,17,3,0,10
14740,470,61111,72524,322,1169,563,606,234,20,557,470,87,1283,1251,6,0,0,9
14741,813,76534,82187,576,1953,991,962,131,6.7,1272,813,459,1957,1851,1,2,0,46
14742,59,-,106510,22,104,22,82,0,0,104,59,45,104,104,0,0,0,0
14743,839,56397,71215,608,2083,1091,992,371,17.8,1111,839,272,2095,1902,1,0,5,0
14744,442,82500,89351,317,1427,686,741,243,17,552,442,110,2186,2007,66,4,48,11
14747,861,52902,68490,530,2017,1083,934,276,13.7,997,861,136,2035,1959,0,0,12,20
14748,232,45000,82885,139,481,254,227,46,9.6,299,232,67,481,438,0,43,0,0
14750,1954,67083,105524,1237,4411,2208,2203,359,8.1,2352,1954,398,4411,4103,37,0,11,22
14752,77,92656,99864,34,171,103,68,9,5.3,109,77,32,171,160,5,0,0,0
14753,436,44167,55778,229,923,417,506,145,15.7,497,436,61,929,885,6,12,0,12
14754,294,60500,89672,160,633,329,304,113,17.9,368,294,74,633,625,0,0,0,0
14755,1154,61346,72617,690,2743,1407,1336,520,19,1487,1154,333,2834,2684,42,64,4,16
14756,0,-,-,0,0,0,0,0,-,119,0,119,0,0,0,0,0,0
14757,1338,63542,91435,764,2832,1331,1501,535,18.9,2181,1338,843,3112,2805,57,10,10,51
14760,7987,52569,70779,4309,17013,8378,8635,3583,21.1,8917,7987,930,17272,15455,328,112,309,139
14767,792,62935,79178,576,2156,1085,1071,222,10.3,880,792,88,2156,2103,0,1,6,19
14769,322,60132,72125,218,849,492,357,181,21.3,380,322,58,849,837,0,0,0,4
14770,1242,52683,67457,756,2787,1436,1351,410,14.7,1299,1242,57,2805,2617,45,2,11,15
14772,1671,78393,82430,1148,4392,2195,2197,654,14.9,1936,1671,265,4431,4227,33,5,0,10
14774,70,-,94156,62,267,133,134,46,17.2,80,70,10,322,284,0,0,0,0
14775,898,50061,65646,603,2272,1197,1075,289,12.7,1170,898,272,2272,2152,0,2,18,35
14777,169,62768,65722,129,528,267,261,71,13.4,577,169,408,531,480,0,0,16,0
14778,0,-,-,0,13,6,7,11,84.6,0,0,0,1428,1226,105,0,37,32
14779,2851,40933,61909,1763,6679,3237,3442,1505,22.5,3519,2851,668,6791,4679,150,1214,15,145
14781,753,65134,76295,499,1790,832,958,244,13.6,900,753,147,1859,1708,4,0,12,14
14782,901,62292,69082,620,2010,1017,993,265,13.2,1166,901,265,2010,1918,28,4,0,0
14783,49,-,82784,28,83,32,51,10,12,122,49,73,83,23,0,45,0,0
14784,352,95227,91712,278,950,481,469,91,9.6,434,352,82,950,869,8,0,0,0
14785,0,-,-,0,0,0,0,0,-,32,0,32,0,0,0,0,0,0
14787,2338,47656,70313,1039,4772,2354,2418,821,17.2,2669,2338,331,4863,4586,8,98,153,0
14788,26,-,N,26,90,74,16,13,14.4,52,26,26,95,35,57,0,0,1
14801,1922,62422,74785,1252,5329,2861,2468,969,18.2,2360,1922,438,5415,5176,32,23,2,42
14802,583,44659,67440,225,1284,739,545,421,32.8,675,583,92,4627,3334,547,45,238,290
14803,574,58537,70613,333,1491,598,893,428,28.7,708,574,134,1491,1461,10,0,5,0
14804,542,74250,87649,396,1482,657,825,175,11.8,772,542,230,1501,1421,1,0,39,1
14805,339,54009,67313,177,723,355,368,153,21.2,484,339,145,723,675,10,6,0,0
14806,769,75368,88757,569,2127,1084,1043,323,15.2,998,769,229,2131,2083,0,1,7,6
14807,1168,64722,82406,747,2865,1418,1447,234,8.2,1385,1168,217,2865,2688,17,38,0,44
14808,240,36250,57398,156,470,252,218,157,33.4,240,240,0,470,452,0,0,3,0
14809,993,62868,81722,676,2908,1647,1261,702,24.1,1239,993,246,2921,2691,1,0,1,85
14810,5351,48613,63299,2727,10945,5268,5677,1875,17.1,6110,5351,759,11412,10740,331,9,13,36
14812,1221,58516,84681,780,2957,1546,1411,307,10.4,1345,1221,124,2961,2756,22,0,10,42
14813,953,68750,82366,609,2332,1233,1099,364,15.6,1274,953,321,2465,2394,45,0,3,1
14814,737,105625,129019,546,2038,1011,1027,128,6.3,737,737,0,2047,1914,14,0,96,0
14815,321,61875,85999,191,704,382,322,117,16.6,739,321,418,725,656,0,0,0,7
14816,225,46417,63784,141,502,233,269,36,7.2,250,225,25,502,454,0,2,0,40
14817,1301,86063,96890,686,2806,1360,1446,265,9.4,1358,1301,57,2811,2324,49,0,63,68
14818,815,84946,121067,619,1819,899,920,186,10.2,1171,815,356,1819,1763,0,0,8,18
14819,234,53750,62961,145,616,304,312,229,37.2,358,234,124,633,614,0,0,0,0
14820,215,63750,87074,135,556,264,292,97,17.4,278,215,63,556,554,0,0,0,0
14821,1143,76830,88006,912,2979,1523,1456,375,12.6,1357,1143,214,3015,2858,14,0,4,35
14822,360,64100,75582,243,819,448,371,137,16.7,516,360,156,826,805,0,0,0,4
14823,1439,64614,77105,960,3694,1940,1754,388,10.5,1856,1439,417,3697,3422,2,11,128,30
14824,309,60417,101387,256,776,438,338,95,12.2,329,309,20,778,740,20,1,0,0
14825,332,60900,91346,204,746,317,429,100,13.4,362,332,30,746,731,1,0,0,0
14826,847,69088,81479,661,2134,1023,1111,298,14,1104,847,257,2134,2061,15,0,0,3
14827,0,-,-,0,0,0,0,0,-,0,0,0,0,0,0,0,0,0
14830,8493,73831,103350,4983,18579,8953,9626,2143,11.5,9324,8493,831,18752,17087,631,2,345,131
14836,483,71487,77487,238,910,485,425,69,7.6,547,483,64,915,864,0,0,0,0
14837,2030,68431,88250,1299,5472,2824,2648,960,17.5,2983,2030,953,5633,5374,59,6,1,7
14838,834,70000,82670,566,2051,1059,992,191,9.3,901,834,67,2150,2069,7,0,0,12
14839,250,76250,89526,184,553,276,277,50,9,375,250,125,553,545,0,0,7,0
14840,1203,84663,108900,816,2509,1298,1211,107,4.3,2774,1203,1571,2514,2379,22,0,10,41
14841,352,65921,85456,215,827,388,439,180,21.8,495,352,143,827,791,0,0,0,0
14842,306,69914,89555,216,930,482,448,134,14.4,767,306,461,930,930,0,0,0,0
14843,5540,56004,72261,3176,12212,6178,6034,2079,17,6353,5540,813,12452,11625,225,2,66,139
14845,8890,76617,97980,5304,20257,10160,10097,1459,7.2,9370,8890,480,20552,18583,422,0,511,84
14846,355,67361,75303,212,939,493,446,120,12.8,451,355,96,978,964,5,0,4,0
14847,929,72981,90157,583,2330,1167,1163,202,8.7,1253,929,324,2385,2241,9,15,26,14
14850,28527,69689,105902,12173,55269,27267,28002,10102,18.3,31772,28527,3245,66495,46992,3187,111,8815,2369
14853,0,-,-,0,0,0,0,0,-,0,0,0,2294,969,389,13,662,224
14854,58,-,98043,54,99,48,51,0,0,58,58,0,99,95,0,0,0,0
14855,300,71458,90175,225,880,404,476,91,10.3,379,300,79,890,857,0,0,0,1
14856,0,-,-,0,0,0,0,0,-,0,0,0,0,0,0,0,0,0
14858,525,75417,86011,365,1401,708,693,99,7.1,618,525,93,1405,1309,0,8,0,11
14859,414,90833,103964,330,1100,555,545,79,7.2,468,414,54,1100,1069,2,1,4,0
14860,480,75500,82387,242,1076,582,494,135,12.5,768,480,288,1079,1026,0,5,0,10
14861,556,60000,81054,377,1356,686,670,139,10.3,632,556,76,1356,1306,12,1,0,0
14864,522,63233,65232,228,1144,664,480,190,16.6,538,522,16,1144,1106,0,6,1,0
14865,1020,50227,62607,587,2550,1142,1408,639,25.1,1151,1020,131,2578,2379,22,9,10,10
14867,2304,67644,89962,1442,5188,2599,2589,458,8.8,2488,2304,184,5188,4890,20,23,0,0
14869,446,81310,94977,292,996,506,490,57,5.7,511,446,65,996,929,12,0,7,0
14870,4157,88514,112710,2803,9963,4925,5038,823,8.3,4691,4157,534,10086,8467,216,0,821,36
14871,1829,76445,95599,1308,4416,1992,2424,634,14.4,1978,1829,149,4497,4408,10,0,6,0
14872,254,60114,69359,196,596,345,251,71,11.9,268,254,14,596,581,15,0,0,0
14873,777,55038,65995,497,1917,952,965,218,11.4,1441,777,664,1937,1782,1,0,46,0
14874,56,88500,84336,40,166,81,85,15,9,119,56,63,166,166,0,0,0,0
14877,219,52188,73575,168,680,406,274,147,21.6,320,219,101,680,639,0,0,28,0
14878,248,56875,93903,171,788,387,401,231,29.3,414,248,166,793,777,0,0,0,6
14879,861,58417,86343,646,2332,1207,1125,276,11.8,1032,861,171,2345,2198,5,0,12,11
14880,700,57833,62876,385,1472,768,704,222,15.1,964,700,264,1475,1363,0,0,47,3
14881,86,82321,127166,54,159,107,52,0,0,97,86,11,159,130,0,0,21,0
14882,1576,94886,137172,1042,4153,1828,2325,417,10,1619,1576,43,4193,3902,158,0,0,0
14883,1849,62431,86286,1318,4497,2263,2234,596,13.3,2062,1849,213,4525,4344,40,0,40,2
14884,160,59167,74379,75,363,206,157,0,0,293,160,133,363,351,0,0,1,0
14885,264,66316,73719,181,656,352,304,36,5.5,318,264,54,659,624,0,0,0,7
14886,2945,80446,96905,2006,6654,3199,3455,627,9.4,3225,2945,280,6654,6164,51,0,24,17
14889,535,62063,77560,338,1333,610,723,169,12.7,632,535,97,1341,1235,12,2,4,5
14891,2057,57137,74857,1010,4503,2307,2196,582,12.9,2602,2057,545,4527,4217,86,9,94,24
14892,3346,52143,83920,2059,7324,3789,3535,779,10.6,3887,3346,541,7531,7134,100,0,78,38
14893,6,-,N,6,30,12,18,24,80,17,6,11,30,30,0,0,0,0
14894,480,51806,67512,271,1120,550,570,269,24,542,480,62,1316,1096,111,26,0,25
14895,3819,59063,86118,2325,8799,4533,4266,1545,17.6,4612,3819,793,9117,8795,86,20,54,0
14897,300,64167,83598,220,770,389,381,40,5.2,387,300,87,770,762,0,0,0,0
14898,521,56188,76715,397,1498,759,739,155,10.3,715,521,194,1501,1404,0,0,6,0
14901,5550,40524,52528,2743,11821,5666,6155,3311,28,6739,5550,1189,14430,10512,2175,66,206,441
14903,3071,66142,99421,1751,7090,3301,3789,1392,19.6,3344,3071,273,7140,5977,537,0,101,64
14904,6419,54563,71472,3411,14272,7184,7088,2971,20.8,7629,6419,1210,14276,11973,999,172,37,61
14905,3859,85888,96468,2494,8865,4005,4860,1272,14.3,4303,3859,444,8976,7439,591,0,262,39
